year,state,level,total_people_by_state_and_level,total_man_by_state_and_level,total_woman_by_state_and_level,total_people_by_state,total_man_by_state,total_woman_by_state
2005,Aguascalientes,1 salario m¡nimo,3157,3157,0,0,0,0
2005,Aguascalientes,Menos de 1 s.m.,118401,111212,7189,0,0,0
2005,Aguascalientes,M s de 1 hasta 2 s.m.,5092,3921,1171,0,0,0
2005,Aguascalientes,M s de 10 s.m.,257632,124638,132994,0,0,0
2005,Aguascalientes,M s de 2 hasta 3 s.m.,140654,135145,5509,0,0,0
2005,Aguascalientes,M s de 3 hasta 5 s.m.,339865,226954,112911,0,0,0
2005,Aguascalientes,M s de 5 hasta 10 s.m.,57276,43896,13380,0,0,0
2005,Aguascalientes,No especificado,14992,9284,5708,0,0,0
2005,Aguascalientes,No recibe ingresos,64577,59987,4590,0,0,0
2005,Baja California,1 salario m¡nimo,3007,2808,199,0,0,0
2005,Baja California,Menos de 1 s.m.,294185,217573,76612,0,0,0
2005,Baja California,M s de 1 hasta 2 s.m.,20085,14338,5747,0,0,0
2005,Baja California,M s de 10 s.m.,748055,418740,329315,0,0,0
2005,Baja California,M s de 2 hasta 3 s.m.,423938,409432,14506,0,0,0
2005,Baja California,M s de 3 hasta 5 s.m.,1065217,638491,426726,0,0,0
2005,Baja California,M s de 5 hasta 10 s.m.,107923,75762,32161,0,0,0
2005,Baja California,No especificado,30403,16961,13442,0,0,0
2005,Baja California,No recibe ingresos,171619,157981,13638,0,0,0
2005,Baja California Sur,1 salario m¡nimo,4601,4175,426,0,0,0
2005,Baja California Sur,Menos de 1 s.m.,107013,87000,20013,0,0,0
2005,Baja California Sur,M s de 1 hasta 2 s.m.,10934,8555,2379,0,0,0
2005,Baja California Sur,M s de 10 s.m.,163214,81908,81306,0,0,0
2005,Baja California Sur,M s de 2 hasta 3 s.m.,101715,97916,3799,0,0,0
2005,Baja California Sur,M s de 3 hasta 5 s.m.,53931,36496,17435,0,0,0
2005,Baja California Sur,M s de 5 hasta 10 s.m.,24307,19059,5248,0,0,0
2005,Baja California Sur,No especificado,6810,3522,3288,0,0,0
2005,Baja California Sur,No recibe ingresos,38176,32888,5288,0,0,0
2005,Campeche,1 salario m¡nimo,27881,20021,7860,0,0,0
2005,Campeche,Menos de 1 s.m.,270087,252119,17968,0,0,0
2005,Campeche,M s de 1 hasta 2 s.m.,5336,4528,808,0,0,0
2005,Campeche,M s de 10 s.m.,197289,83853,113436,0,0,0
2005,Campeche,M s de 2 hasta 3 s.m.,110497,104245,6252,0,0,0
2005,Campeche,M s de 3 hasta 5 s.m.,143653,70379,73274,0,0,0
2005,Campeche,M s de 5 hasta 10 s.m.,19509,15239,4270,0,0,0
2005,Campeche,No especificado,7631,5220,2411,0,0,0
2005,Campeche,No recibe ingresos,39159,38322,837,0,0,0
2005,Chiapas,1 salario m¡nimo,9054,7105,1949,0,0,0
2005,Chiapas,Menos de 1 s.m.,2642672,2468684,173988,0,0,0
2005,Chiapas,M s de 1 hasta 2 s.m.,32363,25358,7005,0,0,0
2005,Chiapas,M s de 10 s.m.,918823,337370,581453,0,0,0
2005,Chiapas,M s de 2 hasta 3 s.m.,415223,407307,7916,0,0,0
2005,Chiapas,M s de 3 hasta 5 s.m.,455759,229204,226555,0,0,0
2005,Chiapas,M s de 5 hasta 10 s.m.,100311,72664,27647,0,0,0
2005,Chiapas,No especificado,23222,12941,10281,0,0,0
2005,Chiapas,No recibe ingresos,210116,202637,7479,0,0,0
2005,Chihuahua,1 salario m¡nimo,10916,10916,0,0,0,0
2005,Chihuahua,Menos de 1 s.m.,500772,478085,22687,0,0,0
2005,Chihuahua,M s de 1 hasta 2 s.m.,32882,27933,4949,0,0,0
2005,Chihuahua,M s de 10 s.m.,814125,471991,342134,0,0,0
2005,Chihuahua,M s de 2 hasta 3 s.m.,363994,351234,12760,0,0,0
2005,Chihuahua,M s de 3 hasta 5 s.m.,1234135,762088,472047,0,0,0
2005,Chihuahua,M s de 5 hasta 10 s.m.,114287,75082,39205,0,0,0
2005,Chihuahua,No especificado,61390,41896,19494,0,0,0
2005,Chihuahua,No recibe ingresos,133321,119070,14251,0,0,0
2005,Ciudad de Mxico,1 salario m¡nimo,23154,17451,5703,0,0,0
2005,Ciudad de Mxico,Menos de 1 s.m.,70315,62886,7429,0,0,0
2005,Ciudad de Mxico,M s de 1 hasta 2 s.m.,81373,74264,7109,0,0,0
2005,Ciudad de Mxico,M s de 10 s.m.,2842201,1484778,1357423,0,0,0
2005,Ciudad de Mxico,M s de 2 hasta 3 s.m.,840869,776214,64655,0,0,0
2005,Ciudad de Mxico,M s de 3 hasta 5 s.m.,2075100,1342309,732791,0,0,0
2005,Ciudad de Mxico,M s de 5 hasta 10 s.m.,549324,364989,184335,0,0,0
2005,Ciudad de Mxico,No especificado,316327,206815,109512,0,0,0
2005,Ciudad de Mxico,No recibe ingresos,987420,912433,74987,0,0,0
2005,Coahuila,1 salario m¡nimo,73789,72336,1453,0,0,0
2005,Coahuila,Menos de 1 s.m.,209940,198458,11482,0,0,0
2005,Coahuila,M s de 1 hasta 2 s.m.,11951,9186,2765,0,0,0
2005,Coahuila,M s de 10 s.m.,622457,320003,302454,0,0,0
2005,Coahuila,M s de 2 hasta 3 s.m.,335803,312270,23533,0,0,0
2005,Coahuila,M s de 3 hasta 5 s.m.,980428,694003,286425,0,0,0
2005,Coahuila,M s de 5 hasta 10 s.m.,123245,89479,33766,0,0,0
2005,Coahuila,No especificado,22394,13363,9031,0,0,0
2005,Coahuila,No recibe ingresos,182370,167181,15189,0,0,0
2005,Colima,1 salario m¡nimo,10688,10536,152,0,0,0
2005,Colima,Menos de 1 s.m.,135707,117300,18407,0,0,0
2005,Colima,M s de 1 hasta 2 s.m.,5016,3825,1191,0,0,0
2005,Colima,M s de 10 s.m.,164486,64983,99503,0,0,0
2005,Colima,M s de 2 hasta 3 s.m.,84446,82052,2394,0,0,0
2005,Colima,M s de 3 hasta 5 s.m.,106815,64599,42216,0,0,0
2005,Colima,M s de 5 hasta 10 s.m.,33846,24943,8903,0,0,0
2005,Colima,No especificado,6980,4310,2670,0,0,0
2005,Colima,No recibe ingresos,57400,50428,6972,0,0,0
2005,Durango,1 salario m¡nimo,26931,23743,3188,0,0,0
2005,Durango,Menos de 1 s.m.,448535,430932,17603,0,0,0
2005,Durango,M s de 1 hasta 2 s.m.,7136,6041,1095,0,0,0
2005,Durango,M s de 10 s.m.,336669,141758,194911,0,0,0
2005,Durango,M s de 2 hasta 3 s.m.,170140,164469,5671,0,0,0
2005,Durango,M s de 3 hasta 5 s.m.,393872,270484,123388,0,0,0
2005,Durango,M s de 5 hasta 10 s.m.,48660,38710,9950,0,0,0
2005,Durango,No especificado,9218,5443,3775,0,0,0
2005,Durango,No recibe ingresos,104780,98619,6161,0,0,0
2005,Estado de Mxico,1 salario m¡nimo,26137,24497,1640,0,0,0
2005,Estado de Mxico,Menos de 1 s.m.,1226255,1069849,156406,0,0,0
2005,Estado de Mxico,M s de 1 hasta 2 s.m.,117735,112767,4968,0,0,0
2005,Estado de Mxico,M s de 10 s.m.,4226176,2168027,2058149,0,0,0
2005,Estado de Mxico,M s de 2 hasta 3 s.m.,2141733,2078078,63655,0,0,0
2005,Estado de Mxico,M s de 3 hasta 5 s.m.,4322859,2817690,1505169,0,0,0
2005,Estado de Mxico,M s de 5 hasta 10 s.m.,579218,460194,119024,0,0,0
2005,Estado de Mxico,No especificado,201765,132354,69411,0,0,0
2005,Estado de Mxico,No recibe ingresos,1352475,1293826,58649,0,0,0
2005,Guanajuato,1 salario m¡nimo,15917,15634,283,0,0,0
2005,Guanajuato,Menos de 1 s.m.,1049491,903120,146371,0,0,0
2005,Guanajuato,M s de 1 hasta 2 s.m.,35605,30873,4732,0,0,0
2005,Guanajuato,M s de 10 s.m.,1476345,609732,866613,0,0,0
2005,Guanajuato,M s de 2 hasta 3 s.m.,604942,590471,14471,0,0,0
2005,Guanajuato,M s de 3 hasta 5 s.m.,1809367,1186471,622896,0,0,0
2005,Guanajuato,M s de 5 hasta 10 s.m.,272621,202879,69742,0,0,0
2005,Guanajuato,No especificado,32572,22644,9928,0,0,0
2005,Guanajuato,No recibe ingresos,205890,185282,20608,0,0,0
2005,Guerrero,1 salario m¡nimo,4557,4017,540,0,0,0
2005,Guerrero,Menos de 1 s.m.,1363224,1199056,164168,0,0,0
2005,Guerrero,M s de 1 hasta 2 s.m.,11583,11379,204,0,0,0
2005,Guerrero,M s de 10 s.m.,679477,244177,435300,0,0,0
2005,Guerrero,M s de 2 hasta 3 s.m.,367203,361419,5784,0,0,0
2005,Guerrero,M s de 3 hasta 5 s.m.,475501,197985,277516,0,0,0
2005,Guerrero,M s de 5 hasta 10 s.m.,90057,69337,20720,0,0,0
2005,Guerrero,No especificado,22613,14169,8444,0,0,0
2005,Guerrero,No recibe ingresos,183591,179652,3939,0,0,0
2005,Hidalgo,1 salario m¡nimo,14494,14494,0,0,0,0
2005,Hidalgo,Menos de 1 s.m.,997895,804160,193735,0,0,0
2005,Hidalgo,M s de 1 hasta 2 s.m.,16623,14208,2415,0,0,0
2005,Hidalgo,M s de 10 s.m.,674046,297455,376591,0,0,0
2005,Hidalgo,M s de 2 hasta 3 s.m.,321051,315395,5656,0,0,0
2005,Hidalgo,M s de 3 hasta 5 s.m.,628898,366647,262251,0,0,0
2005,Hidalgo,M s de 5 hasta 10 s.m.,78030,63171,14859,0,0,0
2005,Hidalgo,No especificado,23294,11340,11954,0,0,0
2005,Hidalgo,No recibe ingresos,114824,110167,4657,0,0,0
2005,Jalisco,1 salario m¡nimo,6265,5999,266,0,0,0
2005,Jalisco,Menos de 1 s.m.,1220570,1016892,203678,0,0,0
2005,Jalisco,M s de 1 hasta 2 s.m.,34066,26089,7977,0,0,0
2005,Jalisco,M s de 10 s.m.,2126076,1014341,1111735,0,0,0
2005,Jalisco,M s de 2 hasta 3 s.m.,918876,900769,18107,0,0,0
2005,Jalisco,M s de 3 hasta 5 s.m.,2293818,1393744,900074,0,0,0
2005,Jalisco,M s de 5 hasta 10 s.m.,335880,257001,78879,0,0,0
2005,Jalisco,No especificado,72049,51186,20863,0,0,0
2005,Jalisco,No recibe ingresos,380103,334518,45585,0,0,0
2005,Michoac n,1 salario m¡nimo,2696,2696,0,0,0,0
2005,Michoac n,Menos de 1 s.m.,1340985,1134775,206210,0,0,0
2005,Michoac n,M s de 1 hasta 2 s.m.,36080,29295,6785,0,0,0
2005,Michoac n,M s de 10 s.m.,1145443,468741,676702,0,0,0
2005,Michoac n,M s de 2 hasta 3 s.m.,474941,470113,4828,0,0,0
2005,Michoac n,M s de 3 hasta 5 s.m.,966032,563544,402488,0,0,0
2005,Michoac n,M s de 5 hasta 10 s.m.,193430,149618,43812,0,0,0
2005,Michoac n,No especificado,27169,14275,12894,0,0,0
2005,Michoac n,No recibe ingresos,251590,234681,16909,0,0,0
2005,Morelos,1 salario m¡nimo,4909,3755,1154,0,0,0
2005,Morelos,Menos de 1 s.m.,352219,319901,32318,0,0,0
2005,Morelos,M s de 1 hasta 2 s.m.,11876,9673,2203,0,0,0
2005,Morelos,M s de 10 s.m.,489074,207077,281997,0,0,0
2005,Morelos,M s de 2 hasta 3 s.m.,276748,272931,3817,0,0,0
2005,Morelos,M s de 3 hasta 5 s.m.,318541,185905,132636,0,0,0
2005,Morelos,M s de 5 hasta 10 s.m.,54730,40841,13889,0,0,0
2005,Morelos,No especificado,16154,10956,5198,0,0,0
2005,Morelos,No recibe ingresos,119786,114378,5408,0,0,0
2005,Nacional,1 salario m¡nimo,729878,643629,86249,0,0,0
2005,Nacional,Menos de 1 s.m.,24876045,21835965,3040080,0,0,0
2005,Nacional,M s de 1 hasta 2 s.m.,758664,635519,123145,0,0,0
2005,Nacional,M s de 10 s.m.,28356171,13195820,15160351,0,0,0
2005,Nacional,M s de 2 hasta 3 s.m.,13316161,12913577,402584,0,0,0
2005,Nacional,M s de 3 hasta 5 s.m.,28237478,17323270,10914208,0,0,0
2005,Nacional,M s de 5 hasta 10 s.m.,4622850,3384279,1238571,0,0,0
2005,Nacional,No especificado,1348425,853412,495013,0,0,0
2005,Nacional,No recibe ingresos,7140941,6648018,492923,0,0,0
2005,Nayarit,1 salario m¡nimo,2598,2442,156,0,0,0
2005,Nayarit,Menos de 1 s.m.,368549,344034,24515,0,0,0
2005,Nayarit,M s de 1 hasta 2 s.m.,6738,4605,2133,0,0,0
2005,Nayarit,M s de 10 s.m.,281517,110943,170574,0,0,0
2005,Nayarit,M s de 2 hasta 3 s.m.,130656,126797,3859,0,0,0
2005,Nayarit,M s de 3 hasta 5 s.m.,144481,76521,67960,0,0,0
2005,Nayarit,M s de 5 hasta 10 s.m.,43445,30998,12447,0,0,0
2005,Nayarit,No especificado,7931,4159,3772,0,0,0
2005,Nayarit,No recibe ingresos,50649,47857,2792,0,0,0
2005,Nuevo Le¢n,1 salario m¡nimo,16713,13727,2986,0,0,0
2005,Nuevo Le¢n,Menos de 1 s.m.,192027,166325,25702,0,0,0
2005,Nuevo Le¢n,M s de 1 hasta 2 s.m.,41090,30490,10600,0,0,0
2005,Nuevo Le¢n,M s de 10 s.m.,1114766,549822,564944,0,0,0
2005,Nuevo Le¢n,M s de 2 hasta 3 s.m.,616716,584297,32419,0,0,0
2005,Nuevo Le¢n,M s de 3 hasta 5 s.m.,1754098,1264616,489482,0,0,0
2005,Nuevo Le¢n,M s de 5 hasta 10 s.m.,307985,221214,86771,0,0,0
2005,Nuevo Le¢n,No especificado,86808,53887,32921,0,0,0
2005,Nuevo Le¢n,No recibe ingresos,388928,362147,26781,0,0,0
2005,Oaxaca,1 salario m¡nimo,17816,15049,2767,0,0,0
2005,Oaxaca,Menos de 1 s.m.,2028288,1706173,322115,0,0,0
2005,Oaxaca,M s de 1 hasta 2 s.m.,8995,7524,1471,0,0,0
2005,Oaxaca,M s de 10 s.m.,813109,266171,546938,0,0,0
2005,Oaxaca,M s de 2 hasta 3 s.m.,348404,343924,4480,0,0,0
2005,Oaxaca,M s de 3 hasta 5 s.m.,811634,280473,531161,0,0,0
2005,Oaxaca,M s de 5 hasta 10 s.m.,89424,57484,31940,0,0,0
2005,Oaxaca,No especificado,21154,11728,9426,0,0,0
2005,Oaxaca,No recibe ingresos,171021,163893,7128,0,0,0
2005,Puebla,1 salario m¡nimo,45632,43843,1789,0,0,0
2005,Puebla,Menos de 1 s.m.,2200394,1674824,525570,0,0,0
2005,Puebla,M s de 1 hasta 2 s.m.,17466,14434,3032,0,0,0
2005,Puebla,M s de 10 s.m.,1308002,555037,752965,0,0,0
2005,Puebla,M s de 2 hasta 3 s.m.,599997,589410,10587,0,0,0
2005,Puebla,M s de 3 hasta 5 s.m.,1692205,944360,747845,0,0,0
2005,Puebla,M s de 5 hasta 10 s.m.,268844,168411,100433,0,0,0
2005,Puebla,No especificado,62661,38440,24221,0,0,0
2005,Puebla,No recibe ingresos,329710,312732,16978,0,0,0
2005,Queretaro,1 salario m¡nimo,9672,9458,214,0,0,0
2005,Queretaro,Menos de 1 s.m.,259386,218408,40978,0,0,0
2005,Queretaro,M s de 1 hasta 2 s.m.,8287,7068,1219,0,0,0
2005,Queretaro,M s de 10 s.m.,408759,174472,234287,0,0,0
2005,Queretaro,M s de 2 hasta 3 s.m.,256319,248977,7342,0,0,0
2005,Queretaro,M s de 3 hasta 5 s.m.,597796,369333,228463,0,0,0
2005,Queretaro,M s de 5 hasta 10 s.m.,74779,54697,20082,0,0,0
2005,Queretaro,No especificado,19751,12136,7615,0,0,0
2005,Queretaro,No recibe ingresos,112606,103086,9520,0,0,0
2005,Quintana Roo,1 salario m¡nimo,3753,3753,0,0,0,0
2005,Quintana Roo,Menos de 1 s.m.,134851,123244,11607,0,0,0
2005,Quintana Roo,M s de 1 hasta 2 s.m.,11201,9769,1432,0,0,0
2005,Quintana Roo,M s de 10 s.m.,345282,160451,184831,0,0,0
2005,Quintana Roo,M s de 2 hasta 3 s.m.,171227,165713,5514,0,0,0
2005,Quintana Roo,M s de 3 hasta 5 s.m.,132509,81598,50911,0,0,0
2005,Quintana Roo,M s de 5 hasta 10 s.m.,48199,37842,10357,0,0,0
2005,Quintana Roo,No especificado,15700,9340,6360,0,0,0
2005,Quintana Roo,No recibe ingresos,123441,113291,10150,0,0,0
2005,San Luis Potos¡,1 salario m¡nimo,34512,33162,1350,0,0,0
2005,San Luis Potos¡,Menos de 1 s.m.,785987,689877,96110,0,0,0
2005,San Luis Potos¡,M s de 1 hasta 2 s.m.,12898,9196,3702,0,0,0
2005,San Luis Potos¡,M s de 10 s.m.,566414,244462,321952,0,0,0
2005,San Luis Potos¡,M s de 2 hasta 3 s.m.,274869,268356,6513,0,0,0
2005,San Luis Potos¡,M s de 3 hasta 5 s.m.,653675,404669,249006,0,0,0
2005,San Luis Potos¡,M s de 5 hasta 10 s.m.,96784,71714,25070,0,0,0
2005,San Luis Potos¡,No especificado,15535,10031,5504,0,0,0
2005,San Luis Potos¡,No recibe ingresos,107238,100358,6880,0,0,0
2005,Sinaloa,1 salario m¡nimo,12681,12392,289,0,0,0
2005,Sinaloa,Menos de 1 s.m.,987954,864323,123631,0,0,0
2005,Sinaloa,M s de 1 hasta 2 s.m.,22205,19385,2820,0,0,0
2005,Sinaloa,M s de 10 s.m.,835113,363074,472039,0,0,0
2005,Sinaloa,M s de 2 hasta 3 s.m.,321081,309418,11663,0,0,0
2005,Sinaloa,M s de 3 hasta 5 s.m.,498356,295652,202704,0,0,0
2005,Sinaloa,M s de 5 hasta 10 s.m.,142187,101345,40842,0,0,0
2005,Sinaloa,No especificado,26969,16846,10123,0,0,0
2005,Sinaloa,No recibe ingresos,126955,106496,20459,0,0,0
2005,Sonora,1 salario m¡nimo,27337,25991,1346,0,0,0
2005,Sonora,Menos de 1 s.m.,419210,371584,47626,0,0,0
2005,Sonora,M s de 1 hasta 2 s.m.,26823,24928,1895,0,0,0
2005,Sonora,M s de 10 s.m.,635832,315294,320538,0,0,0
2005,Sonora,M s de 2 hasta 3 s.m.,357542,347940,9602,0,0,0
2005,Sonora,M s de 3 hasta 5 s.m.,686388,394660,291728,0,0,0
2005,Sonora,M s de 5 hasta 10 s.m.,128732,96150,32582,0,0,0
2005,Sonora,No especificado,33888,19314,14574,0,0,0
2005,Sonora,No recibe ingresos,124858,112205,12653,0,0,0
2005,Tabasco,1 salario m¡nimo,110445,91784,18661,0,0,0
2005,Tabasco,Menos de 1 s.m.,722383,701937,20446,0,0,0
2005,Tabasco,M s de 1 hasta 2 s.m.,13431,11684,1747,0,0,0
2005,Tabasco,M s de 10 s.m.,476118,234345,241773,0,0,0
2005,Tabasco,M s de 2 hasta 3 s.m.,235090,229383,5707,0,0,0
2005,Tabasco,M s de 3 hasta 5 s.m.,191909,143371,48538,0,0,0
2005,Tabasco,M s de 5 hasta 10 s.m.,82467,62844,19623,0,0,0
2005,Tabasco,No especificado,27865,16887,10978,0,0,0
2005,Tabasco,No recibe ingresos,108967,104654,4313,0,0,0
2005,Tamaulipas,1 salario m¡nimo,34336,31198,3138,0,0,0
2005,Tamaulipas,Menos de 1 s.m.,388204,367807,20397,0,0,0
2005,Tamaulipas,M s de 1 hasta 2 s.m.,30992,19277,11715,0,0,0
2005,Tamaulipas,M s de 10 s.m.,803550,422647,380903,0,0,0
2005,Tamaulipas,M s de 2 hasta 3 s.m.,471593,453144,18449,0,0,0
2005,Tamaulipas,M s de 3 hasta 5 s.m.,1048969,599927,449042,0,0,0
2005,Tamaulipas,M s de 5 hasta 10 s.m.,168787,123610,45177,0,0,0
2005,Tamaulipas,No especificado,35399,22951,12448,0,0,0
2005,Tamaulipas,No recibe ingresos,260336,231984,28352,0,0,0
2005,Tlaxcala,1 salario m¡nimo,1464,1319,145,0,0,0
2005,Tlaxcala,Menos de 1 s.m.,280358,253374,26984,0,0,0
2005,Tlaxcala,M s de 1 hasta 2 s.m.,2944,2651,293,0,0,0
2005,Tlaxcala,M s de 10 s.m.,271043,127848,143195,0,0,0
2005,Tlaxcala,M s de 2 hasta 3 s.m.,163380,162414,966,0,0,0
2005,Tlaxcala,M s de 3 hasta 5 s.m.,435095,247466,187629,0,0,0
2005,Tlaxcala,M s de 5 hasta 10 s.m.,24392,18851,5541,0,0,0
2005,Tlaxcala,No especificado,4780,2947,1833,0,0,0
2005,Tlaxcala,No recibe ingresos,56679,55022,1657,0,0,0
2005,Veracruz,1 salario m¡nimo,127531,99195,28336,0,0,0
2005,Veracruz,Menos de 1 s.m.,2775300,2604895,170405,0,0,0
2005,Veracruz,M s de 1 hasta 2 s.m.,58275,44743,13532,0,0,0
2005,Veracruz,M s de 10 s.m.,1765070,752622,1012448,0,0,0
2005,Veracruz,M s de 2 hasta 3 s.m.,848607,835329,13278,0,0,0
2005,Veracruz,M s de 3 hasta 5 s.m.,1120788,721437,399351,0,0,0
2005,Veracruz,M s de 5 hasta 10 s.m.,232021,173558,58463,0,0,0
2005,Veracruz,No especificado,55008,34551,20457,0,0,0
2005,Veracruz,No recibe ingresos,423279,390327,32952,0,0,0
2005,Yucat n,1 salario m¡nimo,3316,3198,118,0,0,0
2005,Yucat n,Menos de 1 s.m.,400663,368926,31737,0,0,0
2005,Yucat n,M s de 1 hasta 2 s.m.,12599,9266,3333,0,0,0
2005,Yucat n,M s de 10 s.m.,477322,217220,260102,0,0,0
2005,Yucat n,M s de 2 hasta 3 s.m.,241485,234474,7011,0,0,0
2005,Yucat n,M s de 3 hasta 5 s.m.,625912,340361,285551,0,0,0
2005,Yucat n,M s de 5 hasta 10 s.m.,100675,78210,22465,0,0,0
2005,Yucat n,No especificado,33726,20050,13676,0,0,0
2005,Yucat n,No recibe ingresos,121979,116836,5143,0,0,0
2005,Zacatecas,1 salario m¡nimo,13919,13778,141,0,0,0
2005,Zacatecas,Menos de 1 s.m.,584225,508232,75993,0,0,0
2005,Zacatecas,M s de 1 hasta 2 s.m.,8984,8266,718,0,0,0
2005,Zacatecas,M s de 10 s.m.,372686,161840,210846,0,0,0
2005,Zacatecas,M s de 2 hasta 3 s.m.,186422,184541,1881,0,0,0
2005,Zacatecas,M s de 3 hasta 5 s.m.,179872,111833,68039,0,0,0
2005,Zacatecas,M s de 5 hasta 10 s.m.,31475,24487,6988,0,0,0
2005,Zacatecas,No especificado,6267,3466,2801,0,0,0
2005,Zacatecas,No recibe ingresos,37098,35080,2018,0,0,0
2006,Aguascalientes,1 salario m¡nimo,2230,2145,85,0,0,0
2006,Aguascalientes,Menos de 1 s.m.,114855,109476,5379,0,0,0
2006,Aguascalientes,M s de 1 hasta 2 s.m.,5224,3877,1347,0,0,0
2006,Aguascalientes,M s de 10 s.m.,289545,140369,149176,0,0,0
2006,Aguascalientes,M s de 2 hasta 3 s.m.,145377,140426,4951,0,0,0
2006,Aguascalientes,M s de 3 hasta 5 s.m.,350759,233644,117115,0,0,0
2006,Aguascalientes,M s de 5 hasta 10 s.m.,60466,47494,12972,0,0,0
2006,Aguascalientes,No especificado,13884,7906,5978,0,0,0
2006,Aguascalientes,No recibe ingresos,63433,58181,5252,0,0,0
2006,Baja California,1 salario m¡nimo,3998,3711,287,0,0,0
2006,Baja California,Menos de 1 s.m.,274203,207565,66638,0,0,0
2006,Baja California,M s de 1 hasta 2 s.m.,28350,23581,4769,0,0,0
2006,Baja California,M s de 10 s.m.,804395,431669,372726,0,0,0
2006,Baja California,M s de 2 hasta 3 s.m.,417166,398572,18594,0,0,0
2006,Baja California,M s de 3 hasta 5 s.m.,1102060,650951,451109,0,0,0
2006,Baja California,M s de 5 hasta 10 s.m.,109644,77152,32492,0,0,0
2006,Baja California,No especificado,42866,27411,15455,0,0,0
2006,Baja California,No recibe ingresos,179639,154500,25139,0,0,0
2006,Baja California Sur,1 salario m¡nimo,5177,5034,143,0,0,0
2006,Baja California Sur,Menos de 1 s.m.,103055,84212,18843,0,0,0
2006,Baja California Sur,M s de 1 hasta 2 s.m.,10652,8288,2364,0,0,0
2006,Baja California Sur,M s de 10 s.m.,166304,84862,81442,0,0,0
2006,Baja California Sur,M s de 2 hasta 3 s.m.,118192,114539,3653,0,0,0
2006,Baja California Sur,M s de 3 hasta 5 s.m.,56452,39466,16986,0,0,0
2006,Baja California Sur,M s de 5 hasta 10 s.m.,25205,19251,5954,0,0,0
2006,Baja California Sur,No especificado,9443,4918,4525,0,0,0
2006,Baja California Sur,No recibe ingresos,42576,38893,3683,0,0,0
2006,Campeche,1 salario m¡nimo,30774,21474,9300,0,0,0
2006,Campeche,Menos de 1 s.m.,245434,231084,14350,0,0,0
2006,Campeche,M s de 1 hasta 2 s.m.,4215,3630,585,0,0,0
2006,Campeche,M s de 10 s.m.,201293,87468,113825,0,0,0
2006,Campeche,M s de 2 hasta 3 s.m.,128728,120909,7819,0,0,0
2006,Campeche,M s de 3 hasta 5 s.m.,133213,67003,66210,0,0,0
2006,Campeche,M s de 5 hasta 10 s.m.,13654,10461,3193,0,0,0
2006,Campeche,No especificado,9744,6818,2926,0,0,0
2006,Campeche,No recibe ingresos,46970,44396,2574,0,0,0
2006,Chiapas,1 salario m¡nimo,2959,2959,0,0,0,0
2006,Chiapas,Menos de 1 s.m.,2577604,2460586,117018,0,0,0
2006,Chiapas,M s de 1 hasta 2 s.m.,24902,20289,4613,0,0,0
2006,Chiapas,M s de 10 s.m.,858564,316632,541932,0,0,0
2006,Chiapas,M s de 2 hasta 3 s.m.,464367,454252,10115,0,0,0
2006,Chiapas,M s de 3 hasta 5 s.m.,501461,265287,236174,0,0,0
2006,Chiapas,M s de 5 hasta 10 s.m.,126599,105286,21313,0,0,0
2006,Chiapas,No especificado,21694,12485,9209,0,0,0
2006,Chiapas,No recibe ingresos,202509,193253,9256,0,0,0
2006,Chihuahua,1 salario m¡nimo,6997,6344,653,0,0,0
2006,Chihuahua,Menos de 1 s.m.,519289,497422,21867,0,0,0
2006,Chihuahua,M s de 1 hasta 2 s.m.,31754,29504,2250,0,0,0
2006,Chihuahua,M s de 10 s.m.,833379,449715,383664,0,0,0
2006,Chihuahua,M s de 2 hasta 3 s.m.,418655,402714,15941,0,0,0
2006,Chihuahua,M s de 3 hasta 5 s.m.,1337460,840146,497314,0,0,0
2006,Chihuahua,M s de 5 hasta 10 s.m.,110698,74014,36684,0,0,0
2006,Chihuahua,No especificado,48274,26805,21469,0,0,0
2006,Chihuahua,No recibe ingresos,153899,139959,13940,0,0,0
2006,Ciudad de Mxico,1 salario m¡nimo,7712,5427,2285,0,0,0
2006,Ciudad de Mxico,Menos de 1 s.m.,79582,68010,11572,0,0,0
2006,Ciudad de Mxico,M s de 1 hasta 2 s.m.,89123,73440,15683,0,0,0
2006,Ciudad de Mxico,M s de 10 s.m.,2821687,1456787,1364900,0,0,0
2006,Ciudad de Mxico,M s de 2 hasta 3 s.m.,848611,815997,32614,0,0,0
2006,Ciudad de Mxico,M s de 3 hasta 5 s.m.,2134051,1324759,809292,0,0,0
2006,Ciudad de Mxico,M s de 5 hasta 10 s.m.,605389,424653,180736,0,0,0
2006,Ciudad de Mxico,No especificado,358945,229704,129241,0,0,0
2006,Ciudad de Mxico,No recibe ingresos,959633,881571,78062,0,0,0
2006,Coahuila,1 salario m¡nimo,69209,64855,4354,0,0,0
2006,Coahuila,Menos de 1 s.m.,222105,210799,11306,0,0,0
2006,Coahuila,M s de 1 hasta 2 s.m.,20005,12107,7898,0,0,0
2006,Coahuila,M s de 10 s.m.,691901,325546,366355,0,0,0
2006,Coahuila,M s de 2 hasta 3 s.m.,337158,318951,18207,0,0,0
2006,Coahuila,M s de 3 hasta 5 s.m.,995875,717056,278819,0,0,0
2006,Coahuila,M s de 5 hasta 10 s.m.,150061,113851,36210,0,0,0
2006,Coahuila,No especificado,35712,23701,12011,0,0,0
2006,Coahuila,No recibe ingresos,173497,160882,12615,0,0,0
2006,Colima,1 salario m¡nimo,11578,11238,340,0,0,0
2006,Colima,Menos de 1 s.m.,135774,116477,19297,0,0,0
2006,Colima,M s de 1 hasta 2 s.m.,8059,6184,1875,0,0,0
2006,Colima,M s de 10 s.m.,175026,67321,107705,0,0,0
2006,Colima,M s de 2 hasta 3 s.m.,99531,96414,3117,0,0,0
2006,Colima,M s de 3 hasta 5 s.m.,97919,61123,36796,0,0,0
2006,Colima,M s de 5 hasta 10 s.m.,36362,26950,9412,0,0,0
2006,Colima,No especificado,11058,7080,3978,0,0,0
2006,Colima,No recibe ingresos,64673,55394,9279,0,0,0
2006,Durango,1 salario m¡nimo,31340,26885,4455,0,0,0
2006,Durango,Menos de 1 s.m.,420940,399176,21764,0,0,0
2006,Durango,M s de 1 hasta 2 s.m.,18347,14411,3936,0,0,0
2006,Durango,M s de 10 s.m.,348987,143931,205056,0,0,0
2006,Durango,M s de 2 hasta 3 s.m.,180582,177568,3014,0,0,0
2006,Durango,M s de 3 hasta 5 s.m.,357643,255418,102225,0,0,0
2006,Durango,M s de 5 hasta 10 s.m.,44458,37957,6501,0,0,0
2006,Durango,No especificado,12847,6990,5857,0,0,0
2006,Durango,No recibe ingresos,105875,97335,8540,0,0,0
2006,Estado de Mxico,1 salario m¡nimo,20934,19092,1842,0,0,0
2006,Estado de Mxico,Menos de 1 s.m.,1215753,1059377,156376,0,0,0
2006,Estado de Mxico,M s de 1 hasta 2 s.m.,83891,67605,16286,0,0,0
2006,Estado de Mxico,M s de 10 s.m.,4373965,2191786,2182179,0,0,0
2006,Estado de Mxico,M s de 2 hasta 3 s.m.,2177886,2121130,56756,0,0,0
2006,Estado de Mxico,M s de 3 hasta 5 s.m.,4462142,2858716,1603426,0,0,0
2006,Estado de Mxico,M s de 5 hasta 10 s.m.,626737,483598,143139,0,0,0
2006,Estado de Mxico,No especificado,271473,181572,89901,0,0,0
2006,Estado de Mxico,No recibe ingresos,1423197,1364426,58771,0,0,0
2006,Guanajuato,1 salario m¡nimo,8392,7655,737,0,0,0
2006,Guanajuato,Menos de 1 s.m.,1065328,927588,137740,0,0,0
2006,Guanajuato,M s de 1 hasta 2 s.m.,32233,28212,4021,0,0,0
2006,Guanajuato,M s de 10 s.m.,1419802,602317,817485,0,0,0
2006,Guanajuato,M s de 2 hasta 3 s.m.,689425,661964,27461,0,0,0
2006,Guanajuato,M s de 3 hasta 5 s.m.,1876549,1207693,668856,0,0,0
2006,Guanajuato,M s de 5 hasta 10 s.m.,283528,203307,80221,0,0,0
2006,Guanajuato,No especificado,48598,27507,21091,0,0,0
2006,Guanajuato,No recibe ingresos,180963,163950,17013,0,0,0
2006,Guerrero,1 salario m¡nimo,4653,4653,0,0,0,0
2006,Guerrero,Menos de 1 s.m.,1335555,1139334,196221,0,0,0
2006,Guerrero,M s de 1 hasta 2 s.m.,11023,9580,1443,0,0,0
2006,Guerrero,M s de 10 s.m.,714800,223982,490818,0,0,0
2006,Guerrero,M s de 2 hasta 3 s.m.,341106,333829,7277,0,0,0
2006,Guerrero,M s de 3 hasta 5 s.m.,526872,211619,315253,0,0,0
2006,Guerrero,M s de 5 hasta 10 s.m.,97982,79825,18157,0,0,0
2006,Guerrero,No especificado,30535,20025,10510,0,0,0
2006,Guerrero,No recibe ingresos,185244,178586,6658,0,0,0
2006,Hidalgo,1 salario m¡nimo,15800,15800,0,0,0,0
2006,Hidalgo,Menos de 1 s.m.,936991,771526,165465,0,0,0
2006,Hidalgo,M s de 1 hasta 2 s.m.,27723,25005,2718,0,0,0
2006,Hidalgo,M s de 10 s.m.,593203,281364,311839,0,0,0
2006,Hidalgo,M s de 2 hasta 3 s.m.,312574,308799,3775,0,0,0
2006,Hidalgo,M s de 3 hasta 5 s.m.,634539,377227,257312,0,0,0
2006,Hidalgo,M s de 5 hasta 10 s.m.,72123,57489,14634,0,0,0
2006,Hidalgo,No especificado,21311,14198,7113,0,0,0
2006,Hidalgo,No recibe ingresos,115717,107540,8177,0,0,0
2006,Jalisco,1 salario m¡nimo,9270,9270,0,0,0,0
2006,Jalisco,Menos de 1 s.m.,1110505,934904,175601,0,0,0
2006,Jalisco,M s de 1 hasta 2 s.m.,37379,30742,6637,0,0,0
2006,Jalisco,M s de 10 s.m.,2079967,984607,1095360,0,0,0
2006,Jalisco,M s de 2 hasta 3 s.m.,1013480,982145,31335,0,0,0
2006,Jalisco,M s de 3 hasta 5 s.m.,2441473,1466134,975339,0,0,0
2006,Jalisco,M s de 5 hasta 10 s.m.,374357,282211,92146,0,0,0
2006,Jalisco,No especificado,88997,52829,36168,0,0,0
2006,Jalisco,No recibe ingresos,423171,387677,35494,0,0,0
2006,Michoac n,1 salario m¡nimo,1713,1713,0,0,0,0
2006,Michoac n,Menos de 1 s.m.,1508045,1274373,233672,0,0,0
2006,Michoac n,M s de 1 hasta 2 s.m.,34025,26149,7876,0,0,0
2006,Michoac n,M s de 10 s.m.,1193395,459413,733982,0,0,0
2006,Michoac n,M s de 2 hasta 3 s.m.,481337,475605,5732,0,0,0
2006,Michoac n,M s de 3 hasta 5 s.m.,913794,554464,359330,0,0,0
2006,Michoac n,M s de 5 hasta 10 s.m.,174278,144723,29555,0,0,0
2006,Michoac n,No especificado,54132,35205,18927,0,0,0
2006,Michoac n,No recibe ingresos,233663,212476,21187,0,0,0
2006,Morelos,1 salario m¡nimo,2304,1966,338,0,0,0
2006,Morelos,Menos de 1 s.m.,358481,325002,33479,0,0,0
2006,Morelos,M s de 1 hasta 2 s.m.,17105,13853,3252,0,0,0
2006,Morelos,M s de 10 s.m.,529510,232355,297155,0,0,0
2006,Morelos,M s de 2 hasta 3 s.m.,294175,288893,5282,0,0,0
2006,Morelos,M s de 3 hasta 5 s.m.,335613,199165,136448,0,0,0
2006,Morelos,M s de 5 hasta 10 s.m.,46537,36467,10070,0,0,0
2006,Morelos,No especificado,13696,9297,4399,0,0,0
2006,Morelos,No recibe ingresos,112583,104466,8117,0,0,0
2006,Nacional,1 salario m¡nimo,684391,614539,69852,0,0,0
2006,Nacional,Menos de 1 s.m.,24506670,21495166,3011504,0,0,0
2006,Nacional,M s de 1 hasta 2 s.m.,800645,645153,155492,0,0,0
2006,Nacional,M s de 10 s.m.,29258687,13353258,15905429,0,0,0
2006,Nacional,M s de 2 hasta 3 s.m.,14157868,13726449,431419,0,0,0
2006,Nacional,M s de 3 hasta 5 s.m.,29122296,17730948,11391348,0,0,0
2006,Nacional,M s de 5 hasta 10 s.m.,4702020,3525965,1176055,0,0,0
2006,Nacional,No especificado,1601495,1017238,584257,0,0,0
2006,Nacional,No recibe ingresos,7298867,6785122,513745,0,0,0
2006,Nayarit,1 salario m¡nimo,2347,2228,119,0,0,0
2006,Nayarit,Menos de 1 s.m.,340091,316625,23466,0,0,0
2006,Nayarit,M s de 1 hasta 2 s.m.,7534,5690,1844,0,0,0
2006,Nayarit,M s de 10 s.m.,317542,117546,199996,0,0,0
2006,Nayarit,M s de 2 hasta 3 s.m.,136097,133423,2674,0,0,0
2006,Nayarit,M s de 3 hasta 5 s.m.,151016,87959,63057,0,0,0
2006,Nayarit,M s de 5 hasta 10 s.m.,41028,31682,9346,0,0,0
2006,Nayarit,No especificado,7663,4516,3147,0,0,0
2006,Nayarit,No recibe ingresos,54227,52147,2080,0,0,0
2006,Nuevo Le¢n,1 salario m¡nimo,16147,15186,961,0,0,0
2006,Nuevo Le¢n,Menos de 1 s.m.,182134,165882,16252,0,0,0
2006,Nuevo Le¢n,M s de 1 hasta 2 s.m.,36584,24497,12087,0,0,0
2006,Nuevo Le¢n,M s de 10 s.m.,1179429,577241,602188,0,0,0
2006,Nuevo Le¢n,M s de 2 hasta 3 s.m.,685567,657675,27892,0,0,0
2006,Nuevo Le¢n,M s de 3 hasta 5 s.m.,1815295,1293267,522028,0,0,0
2006,Nuevo Le¢n,M s de 5 hasta 10 s.m.,288329,214847,73482,0,0,0
2006,Nuevo Le¢n,No especificado,96665,67464,29201,0,0,0
2006,Nuevo Le¢n,No recibe ingresos,404719,369993,34726,0,0,0
2006,Oaxaca,1 salario m¡nimo,18346,16561,1785,0,0,0
2006,Oaxaca,Menos de 1 s.m.,2074693,1698759,375934,0,0,0
2006,Oaxaca,M s de 1 hasta 2 s.m.,7734,6745,989,0,0,0
2006,Oaxaca,M s de 10 s.m.,798388,235183,563205,0,0,0
2006,Oaxaca,M s de 2 hasta 3 s.m.,389092,381424,7668,0,0,0
2006,Oaxaca,M s de 3 hasta 5 s.m.,702603,230602,472001,0,0,0
2006,Oaxaca,M s de 5 hasta 10 s.m.,90211,74174,16037,0,0,0
2006,Oaxaca,No especificado,30389,13809,16580,0,0,0
2006,Oaxaca,No recibe ingresos,180184,175319,4865,0,0,0
2006,Puebla,1 salario m¡nimo,41671,41671,0,0,0,0
2006,Puebla,Menos de 1 s.m.,2103089,1600210,502879,0,0,0
2006,Puebla,M s de 1 hasta 2 s.m.,11897,7882,4015,0,0,0
2006,Puebla,M s de 10 s.m.,1556511,652618,903893,0,0,0
2006,Puebla,M s de 2 hasta 3 s.m.,580908,568434,12474,0,0,0
2006,Puebla,M s de 3 hasta 5 s.m.,1794171,979182,814989,0,0,0
2006,Puebla,M s de 5 hasta 10 s.m.,230257,161875,68382,0,0,0
2006,Puebla,No especificado,51943,34516,17427,0,0,0
2006,Puebla,No recibe ingresos,328819,309132,19687,0,0,0
2006,Queretaro,1 salario m¡nimo,7507,7351,156,0,0,0
2006,Queretaro,Menos de 1 s.m.,214784,186495,28289,0,0,0
2006,Queretaro,M s de 1 hasta 2 s.m.,8119,6921,1198,0,0,0
2006,Queretaro,M s de 10 s.m.,414392,179887,234505,0,0,0
2006,Queretaro,M s de 2 hasta 3 s.m.,279935,269183,10752,0,0,0
2006,Queretaro,M s de 3 hasta 5 s.m.,609477,367862,241615,0,0,0
2006,Queretaro,M s de 5 hasta 10 s.m.,75853,58100,17753,0,0,0
2006,Queretaro,No especificado,28406,18969,9437,0,0,0
2006,Queretaro,No recibe ingresos,107715,99307,8408,0,0,0
2006,Quintana Roo,1 salario m¡nimo,1821,1691,130,0,0,0
2006,Quintana Roo,Menos de 1 s.m.,127485,116317,11168,0,0,0
2006,Quintana Roo,M s de 1 hasta 2 s.m.,17027,15316,1711,0,0,0
2006,Quintana Roo,M s de 10 s.m.,364238,161099,203139,0,0,0
2006,Quintana Roo,M s de 2 hasta 3 s.m.,236672,224184,12488,0,0,0
2006,Quintana Roo,M s de 3 hasta 5 s.m.,156482,89832,66650,0,0,0
2006,Quintana Roo,M s de 5 hasta 10 s.m.,55607,41392,14215,0,0,0
2006,Quintana Roo,No especificado,20951,13933,7018,0,0,0
2006,Quintana Roo,No recibe ingresos,115105,107369,7736,0,0,0
2006,San Luis Potos¡,1 salario m¡nimo,35563,35164,399,0,0,0
2006,San Luis Potos¡,Menos de 1 s.m.,771088,682908,88180,0,0,0
2006,San Luis Potos¡,M s de 1 hasta 2 s.m.,11299,8874,2425,0,0,0
2006,San Luis Potos¡,M s de 10 s.m.,587372,240882,346490,0,0,0
2006,San Luis Potos¡,M s de 2 hasta 3 s.m.,298952,291705,7247,0,0,0
2006,San Luis Potos¡,M s de 3 hasta 5 s.m.,658519,406259,252260,0,0,0
2006,San Luis Potos¡,M s de 5 hasta 10 s.m.,124466,94044,30422,0,0,0
2006,San Luis Potos¡,No especificado,18415,10150,8265,0,0,0
2006,San Luis Potos¡,No recibe ingresos,113248,102249,10999,0,0,0
2006,Sinaloa,1 salario m¡nimo,8796,8796,0,0,0,0
2006,Sinaloa,Menos de 1 s.m.,938254,841711,96543,0,0,0
2006,Sinaloa,M s de 1 hasta 2 s.m.,29123,24525,4598,0,0,0
2006,Sinaloa,M s de 10 s.m.,843696,354591,489105,0,0,0
2006,Sinaloa,M s de 2 hasta 3 s.m.,321646,308829,12817,0,0,0
2006,Sinaloa,M s de 3 hasta 5 s.m.,486829,286725,200104,0,0,0
2006,Sinaloa,M s de 5 hasta 10 s.m.,150720,103963,46757,0,0,0
2006,Sinaloa,No especificado,43379,32897,10482,0,0,0
2006,Sinaloa,No recibe ingresos,150466,140350,10116,0,0,0
2006,Sonora,1 salario m¡nimo,20143,18271,1872,0,0,0
2006,Sonora,Menos de 1 s.m.,385515,340292,45223,0,0,0
2006,Sonora,M s de 1 hasta 2 s.m.,23565,20490,3075,0,0,0
2006,Sonora,M s de 10 s.m.,699848,337884,361964,0,0,0
2006,Sonora,M s de 2 hasta 3 s.m.,408867,397153,11714,0,0,0
2006,Sonora,M s de 3 hasta 5 s.m.,767249,445162,322087,0,0,0
2006,Sonora,M s de 5 hasta 10 s.m.,124924,90963,33961,0,0,0
2006,Sonora,No especificado,24558,16849,7709,0,0,0
2006,Sonora,No recibe ingresos,122345,107314,15031,0,0,0
2006,Tabasco,1 salario m¡nimo,139945,119608,20337,0,0,0
2006,Tabasco,Menos de 1 s.m.,630559,612932,17627,0,0,0
2006,Tabasco,M s de 1 hasta 2 s.m.,23807,19343,4464,0,0,0
2006,Tabasco,M s de 10 s.m.,478477,239604,238873,0,0,0
2006,Tabasco,M s de 2 hasta 3 s.m.,264617,258968,5649,0,0,0
2006,Tabasco,M s de 3 hasta 5 s.m.,209004,146840,62164,0,0,0
2006,Tabasco,M s de 5 hasta 10 s.m.,72381,57331,15050,0,0,0
2006,Tabasco,No especificado,25331,13525,11806,0,0,0
2006,Tabasco,No recibe ingresos,125508,121471,4037,0,0,0
2006,Tamaulipas,1 salario m¡nimo,36562,34384,2178,0,0,0
2006,Tamaulipas,Menos de 1 s.m.,379397,361708,17689,0,0,0
2006,Tamaulipas,M s de 1 hasta 2 s.m.,27433,18518,8915,0,0,0
2006,Tamaulipas,M s de 10 s.m.,863964,418805,445159,0,0,0
2006,Tamaulipas,M s de 2 hasta 3 s.m.,471896,455126,16770,0,0,0
2006,Tamaulipas,M s de 3 hasta 5 s.m.,1100696,653760,446936,0,0,0
2006,Tamaulipas,M s de 5 hasta 10 s.m.,142936,100045,42891,0,0,0
2006,Tamaulipas,No especificado,47799,31618,16181,0,0,0
2006,Tamaulipas,No recibe ingresos,255428,230410,25018,0,0,0
2006,Tlaxcala,1 salario m¡nimo,717,287,430,0,0,0
2006,Tlaxcala,Menos de 1 s.m.,266273,236974,29299,0,0,0
2006,Tlaxcala,M s de 1 hasta 2 s.m.,2524,2067,457,0,0,0
2006,Tlaxcala,M s de 10 s.m.,287644,131276,156368,0,0,0
2006,Tlaxcala,M s de 2 hasta 3 s.m.,163799,161627,2172,0,0,0
2006,Tlaxcala,M s de 3 hasta 5 s.m.,430606,251228,179378,0,0,0
2006,Tlaxcala,M s de 5 hasta 10 s.m.,27223,23364,3859,0,0,0
2006,Tlaxcala,No especificado,9400,6029,3371,0,0,0
2006,Tlaxcala,No recibe ingresos,60315,58187,2128,0,0,0
2006,Veracruz,1 salario m¡nimo,97916,82153,15763,0,0,0
2006,Veracruz,Menos de 1 s.m.,2861209,2654784,206425,0,0,0
2006,Veracruz,M s de 1 hasta 2 s.m.,84528,68528,16000,0,0,0
2006,Veracruz,M s de 10 s.m.,1945204,872508,1072696,0,0,0
2006,Veracruz,M s de 2 hasta 3 s.m.,970123,933023,37100,0,0,0
2006,Veracruz,M s de 3 hasta 5 s.m.,1117344,689378,427966,0,0,0
2006,Veracruz,M s de 5 hasta 10 s.m.,191157,147984,43173,0,0,0
2006,Veracruz,No especificado,69114,35187,33927,0,0,0
2006,Veracruz,No recibe ingresos,446331,408881,37450,0,0,0
2006,Yucat n,1 salario m¡nimo,5800,5422,378,0,0,0
2006,Yucat n,Menos de 1 s.m.,388177,352488,35689,0,0,0
2006,Yucat n,M s de 1 hasta 2 s.m.,17634,12068,5566,0,0,0
2006,Yucat n,M s de 10 s.m.,475662,217440,258222,0,0,0
2006,Yucat n,M s de 2 hasta 3 s.m.,281769,275716,6053,0,0,0
2006,Yucat n,M s de 3 hasta 5 s.m.,684506,362178,322328,0,0,0
2006,Yucat n,M s de 5 hasta 10 s.m.,96048,75190,20858,0,0,0
2006,Yucat n,No especificado,25879,18674,7205,0,0,0
2006,Yucat n,No recibe ingresos,129719,122942,6777,0,0,0
2006,Zacatecas,1 salario m¡nimo,16070,15545,525,0,0,0
2006,Zacatecas,Menos de 1 s.m.,620423,510170,110253,0,0,0
2006,Zacatecas,M s de 1 hasta 2 s.m.,7827,7232,595,0,0,0
2006,Zacatecas,M s de 10 s.m.,350597,136570,214027,0,0,0
2006,Zacatecas,M s de 2 hasta 3 s.m.,199578,197272,2306,0,0,0
2006,Zacatecas,M s de 3 hasta 5 s.m.,180624,110843,69781,0,0,0
2006,Zacatecas,M s de 5 hasta 10 s.m.,32802,26322,6480,0,0,0
2006,Zacatecas,No especificado,8394,4651,3743,0,0,0
2006,Zacatecas,No recibe ingresos,37496,36566,930,0,0,0
2007,Aguascalientes,1 salario m¡nimo,2527,2413,114,0,0,0
2007,Aguascalientes,Menos de 1 s.m.,109410,103166,6244,0,0,0
2007,Aguascalientes,M s de 1 hasta 2 s.m.,5718,4481,1237,0,0,0
2007,Aguascalientes,M s de 10 s.m.,299464,144117,155347,0,0,0
2007,Aguascalientes,M s de 2 hasta 3 s.m.,161370,154251,7119,0,0,0
2007,Aguascalientes,M s de 3 hasta 5 s.m.,372161,246272,125889,0,0,0
2007,Aguascalientes,M s de 5 hasta 10 s.m.,48407,38274,10133,0,0,0
2007,Aguascalientes,No especificado,13908,9205,4703,0,0,0
2007,Aguascalientes,No recibe ingresos,62033,56692,5341,0,0,0
2007,Baja California,1 salario m¡nimo,2555,2436,119,0,0,0
2007,Baja California,Menos de 1 s.m.,268325,205736,62589,0,0,0
2007,Baja California,M s de 1 hasta 2 s.m.,34938,25227,9711,0,0,0
2007,Baja California,M s de 10 s.m.,868467,461496,406971,0,0,0
2007,Baja California,M s de 2 hasta 3 s.m.,445300,426421,18879,0,0,0
2007,Baja California,M s de 3 hasta 5 s.m.,1112135,639419,472716,0,0,0
2007,Baja California,M s de 5 hasta 10 s.m.,100589,76404,24185,0,0,0
2007,Baja California,No especificado,28930,16926,12004,0,0,0
2007,Baja California,No recibe ingresos,184628,161851,22777,0,0,0
2007,Baja California Sur,1 salario m¡nimo,5368,4757,611,0,0,0
2007,Baja California Sur,Menos de 1 s.m.,100822,83123,17699,0,0,0
2007,Baja California Sur,M s de 1 hasta 2 s.m.,12797,10644,2153,0,0,0
2007,Baja California Sur,M s de 10 s.m.,171275,84068,87207,0,0,0
2007,Baja California Sur,M s de 2 hasta 3 s.m.,131818,125446,6372,0,0,0
2007,Baja California Sur,M s de 3 hasta 5 s.m.,64261,43317,20944,0,0,0
2007,Baja California Sur,M s de 5 hasta 10 s.m.,28428,19766,8662,0,0,0
2007,Baja California Sur,No especificado,8212,4488,3724,0,0,0
2007,Baja California Sur,No recibe ingresos,47042,42957,4085,0,0,0
2007,Campeche,1 salario m¡nimo,35639,27692,7947,0,0,0
2007,Campeche,Menos de 1 s.m.,248735,236085,12650,0,0,0
2007,Campeche,M s de 1 hasta 2 s.m.,7174,6464,710,0,0,0
2007,Campeche,M s de 10 s.m.,203848,85364,118484,0,0,0
2007,Campeche,M s de 2 hasta 3 s.m.,124052,119075,4977,0,0,0
2007,Campeche,M s de 3 hasta 5 s.m.,125609,66457,59152,0,0,0
2007,Campeche,M s de 5 hasta 10 s.m.,17721,13802,3919,0,0,0
2007,Campeche,No especificado,7566,4516,3050,0,0,0
2007,Campeche,No recibe ingresos,45604,43664,1940,0,0,0
2007,Chiapas,1 salario m¡nimo,3529,3529,0,0,0,0
2007,Chiapas,Menos de 1 s.m.,2513697,2396068,117629,0,0,0
2007,Chiapas,M s de 1 hasta 2 s.m.,27143,23586,3557,0,0,0
2007,Chiapas,M s de 10 s.m.,982745,348183,634562,0,0,0
2007,Chiapas,M s de 2 hasta 3 s.m.,492671,482913,9758,0,0,0
2007,Chiapas,M s de 3 hasta 5 s.m.,542017,278146,263871,0,0,0
2007,Chiapas,M s de 5 hasta 10 s.m.,121355,100837,20518,0,0,0
2007,Chiapas,No especificado,18287,14021,4266,0,0,0
2007,Chiapas,No recibe ingresos,217815,211916,5899,0,0,0
2007,Chihuahua,1 salario m¡nimo,22410,21111,1299,0,0,0
2007,Chihuahua,Menos de 1 s.m.,551088,532978,18110,0,0,0
2007,Chihuahua,M s de 1 hasta 2 s.m.,29625,27265,2360,0,0,0
2007,Chihuahua,M s de 10 s.m.,906809,499108,407701,0,0,0
2007,Chihuahua,M s de 2 hasta 3 s.m.,431532,413047,18485,0,0,0
2007,Chihuahua,M s de 3 hasta 5 s.m.,1256584,778765,477819,0,0,0
2007,Chihuahua,M s de 5 hasta 10 s.m.,111009,90709,20300,0,0,0
2007,Chihuahua,No especificado,50127,38516,11611,0,0,0
2007,Chihuahua,No recibe ingresos,138118,130075,8043,0,0,0
2007,Ciudad de Mxico,1 salario m¡nimo,5751,3694,2057,0,0,0
2007,Ciudad de Mxico,Menos de 1 s.m.,80883,68850,12033,0,0,0
2007,Ciudad de Mxico,M s de 1 hasta 2 s.m.,73915,62613,11302,0,0,0
2007,Ciudad de Mxico,M s de 10 s.m.,2854250,1412231,1442019,0,0,0
2007,Ciudad de Mxico,M s de 2 hasta 3 s.m.,818599,761428,57171,0,0,0
2007,Ciudad de Mxico,M s de 3 hasta 5 s.m.,2228070,1427061,801009,0,0,0
2007,Ciudad de Mxico,M s de 5 hasta 10 s.m.,564992,393735,171257,0,0,0
2007,Ciudad de Mxico,No especificado,357926,227580,130346,0,0,0
2007,Ciudad de Mxico,No recibe ingresos,899874,801727,98147,0,0,0
2007,Coahuila,1 salario m¡nimo,74465,70205,4260,0,0,0
2007,Coahuila,Menos de 1 s.m.,229458,213533,15925,0,0,0
2007,Coahuila,M s de 1 hasta 2 s.m.,28269,19826,8443,0,0,0
2007,Coahuila,M s de 10 s.m.,719355,341313,378042,0,0,0
2007,Coahuila,M s de 2 hasta 3 s.m.,344758,337837,6921,0,0,0
2007,Coahuila,M s de 3 hasta 5 s.m.,1030613,743854,286759,0,0,0
2007,Coahuila,M s de 5 hasta 10 s.m.,130947,98409,32538,0,0,0
2007,Coahuila,No especificado,40681,24105,16576,0,0,0
2007,Coahuila,No recibe ingresos,169828,163678,6150,0,0,0
2007,Colima,1 salario m¡nimo,11254,11175,79,0,0,0
2007,Colima,Menos de 1 s.m.,141671,121787,19884,0,0,0
2007,Colima,M s de 1 hasta 2 s.m.,5670,4621,1049,0,0,0
2007,Colima,M s de 10 s.m.,178784,67444,111340,0,0,0
2007,Colima,M s de 2 hasta 3 s.m.,101363,97670,3693,0,0,0
2007,Colima,M s de 3 hasta 5 s.m.,90428,59454,30974,0,0,0
2007,Colima,M s de 5 hasta 10 s.m.,28788,19824,8964,0,0,0
2007,Colima,No especificado,10347,6170,4177,0,0,0
2007,Colima,No recibe ingresos,67687,55570,12117,0,0,0
2007,Durango,1 salario m¡nimo,34085,31775,2310,0,0,0
2007,Durango,Menos de 1 s.m.,426744,403437,23307,0,0,0
2007,Durango,M s de 1 hasta 2 s.m.,10512,7631,2881,0,0,0
2007,Durango,M s de 10 s.m.,401820,182731,219089,0,0,0
2007,Durango,M s de 2 hasta 3 s.m.,190429,187922,2507,0,0,0
2007,Durango,M s de 3 hasta 5 s.m.,362622,249669,112953,0,0,0
2007,Durango,M s de 5 hasta 10 s.m.,54004,43329,10675,0,0,0
2007,Durango,No especificado,11703,6827,4876,0,0,0
2007,Durango,No recibe ingresos,106896,101056,5840,0,0,0
2007,Estado de Mxico,1 salario m¡nimo,15373,15279,94,0,0,0
2007,Estado de Mxico,Menos de 1 s.m.,1249195,1115100,134095,0,0,0
2007,Estado de Mxico,M s de 1 hasta 2 s.m.,127062,109632,17430,0,0,0
2007,Estado de Mxico,M s de 10 s.m.,4299943,2135386,2164557,0,0,0
2007,Estado de Mxico,M s de 2 hasta 3 s.m.,2329121,2264552,64569,0,0,0
2007,Estado de Mxico,M s de 3 hasta 5 s.m.,4444737,2845665,1599072,0,0,0
2007,Estado de Mxico,M s de 5 hasta 10 s.m.,663599,494395,169204,0,0,0
2007,Estado de Mxico,No especificado,193051,110161,82890,0,0,0
2007,Estado de Mxico,No recibe ingresos,1461084,1387382,73702,0,0,0
2007,Guanajuato,1 salario m¡nimo,6511,6511,0,0,0,0
2007,Guanajuato,Menos de 1 s.m.,926340,811950,114390,0,0,0
2007,Guanajuato,M s de 1 hasta 2 s.m.,34622,28396,6226,0,0,0
2007,Guanajuato,M s de 10 s.m.,1500824,628840,871984,0,0,0
2007,Guanajuato,M s de 2 hasta 3 s.m.,712652,694138,18514,0,0,0
2007,Guanajuato,M s de 3 hasta 5 s.m.,1988196,1289426,698770,0,0,0
2007,Guanajuato,M s de 5 hasta 10 s.m.,278737,210353,68384,0,0,0
2007,Guanajuato,No especificado,37789,20194,17595,0,0,0
2007,Guanajuato,No recibe ingresos,226971,210222,16749,0,0,0
2007,Guerrero,1 salario m¡nimo,9200,9200,0,0,0,0
2007,Guerrero,Menos de 1 s.m.,1418113,1187389,230724,0,0,0
2007,Guerrero,M s de 1 hasta 2 s.m.,22457,19678,2779,0,0,0
2007,Guerrero,M s de 10 s.m.,781596,265099,516497,0,0,0
2007,Guerrero,M s de 2 hasta 3 s.m.,324137,315735,8402,0,0,0
2007,Guerrero,M s de 3 hasta 5 s.m.,500706,180963,319743,0,0,0
2007,Guerrero,M s de 5 hasta 10 s.m.,89444,72137,17307,0,0,0
2007,Guerrero,No especificado,22645,13983,8662,0,0,0
2007,Guerrero,No recibe ingresos,202285,196088,6197,0,0,0
2007,Hidalgo,1 salario m¡nimo,12067,11627,440,0,0,0
2007,Hidalgo,Menos de 1 s.m.,915393,731666,183727,0,0,0
2007,Hidalgo,M s de 1 hasta 2 s.m.,22657,20479,2178,0,0,0
2007,Hidalgo,M s de 10 s.m.,611637,268185,343452,0,0,0
2007,Hidalgo,M s de 2 hasta 3 s.m.,310668,304281,6387,0,0,0
2007,Hidalgo,M s de 3 hasta 5 s.m.,616372,381706,234666,0,0,0
2007,Hidalgo,M s de 5 hasta 10 s.m.,81337,68058,13279,0,0,0
2007,Hidalgo,No especificado,17653,12247,5406,0,0,0
2007,Hidalgo,No recibe ingresos,97380,92253,5127,0,0,0
2007,Jalisco,1 salario m¡nimo,7137,5194,1943,0,0,0
2007,Jalisco,Menos de 1 s.m.,1106265,964283,141982,0,0,0
2007,Jalisco,M s de 1 hasta 2 s.m.,38792,33244,5548,0,0,0
2007,Jalisco,M s de 10 s.m.,2273493,1052204,1221289,0,0,0
2007,Jalisco,M s de 2 hasta 3 s.m.,1030007,991419,38588,0,0,0
2007,Jalisco,M s de 3 hasta 5 s.m.,2385505,1573037,812468,0,0,0
2007,Jalisco,M s de 5 hasta 10 s.m.,348440,252974,95466,0,0,0
2007,Jalisco,No especificado,86366,46331,40035,0,0,0
2007,Jalisco,No recibe ingresos,404430,365113,39317,0,0,0
2007,Michoac n,1 salario m¡nimo,4724,4724,0,0,0,0
2007,Michoac n,Menos de 1 s.m.,1354877,1187917,166960,0,0,0
2007,Michoac n,M s de 1 hasta 2 s.m.,26737,21437,5300,0,0,0
2007,Michoac n,M s de 10 s.m.,1213680,475091,738589,0,0,0
2007,Michoac n,M s de 2 hasta 3 s.m.,558341,551943,6398,0,0,0
2007,Michoac n,M s de 3 hasta 5 s.m.,866776,540553,326223,0,0,0
2007,Michoac n,M s de 5 hasta 10 s.m.,157516,117289,40227,0,0,0
2007,Michoac n,No especificado,32860,14801,18059,0,0,0
2007,Michoac n,No recibe ingresos,251778,239135,12643,0,0,0
2007,Morelos,1 salario m¡nimo,3523,3181,342,0,0,0
2007,Morelos,Menos de 1 s.m.,361200,325990,35210,0,0,0
2007,Morelos,M s de 1 hasta 2 s.m.,16868,14232,2636,0,0,0
2007,Morelos,M s de 10 s.m.,548710,234782,313928,0,0,0
2007,Morelos,M s de 2 hasta 3 s.m.,299090,292214,6876,0,0,0
2007,Morelos,M s de 3 hasta 5 s.m.,316762,190547,126215,0,0,0
2007,Morelos,M s de 5 hasta 10 s.m.,44093,34130,9963,0,0,0
2007,Morelos,No especificado,16966,12566,4400,0,0,0
2007,Morelos,No recibe ingresos,130492,121239,9253,0,0,0
2007,Nacional,1 salario m¡nimo,747994,664601,83393,0,0,0
2007,Nacional,Menos de 1 s.m.,24179640,21114891,3064749,0,0,0
2007,Nacional,M s de 1 hasta 2 s.m.,837480,696086,141394,0,0,0
2007,Nacional,M s de 10 s.m.,30328993,13681714,16647279,0,0,0
2007,Nacional,M s de 2 hasta 3 s.m.,14860166,14390297,469869,0,0,0
2007,Nacional,M s de 3 hasta 5 s.m.,29225159,17965409,11259750,0,0,0
2007,Nacional,M s de 5 hasta 10 s.m.,4602877,3403327,1199550,0,0,0
2007,Nacional,No especificado,1408254,880388,527866,0,0,0
2007,Nacional,No recibe ingresos,7273496,6752503,520993,0,0,0
2007,Nayarit,1 salario m¡nimo,4286,4015,271,0,0,0
2007,Nayarit,Menos de 1 s.m.,342717,320525,22192,0,0,0
2007,Nayarit,M s de 1 hasta 2 s.m.,4955,3751,1204,0,0,0
2007,Nayarit,M s de 10 s.m.,323276,119354,203922,0,0,0
2007,Nayarit,M s de 2 hasta 3 s.m.,142741,138481,4260,0,0,0
2007,Nayarit,M s de 3 hasta 5 s.m.,156407,89857,66550,0,0,0
2007,Nayarit,M s de 5 hasta 10 s.m.,36008,28761,7247,0,0,0
2007,Nayarit,No especificado,8695,4959,3736,0,0,0
2007,Nayarit,No recibe ingresos,55854,53023,2831,0,0,0
2007,Nuevo Le¢n,1 salario m¡nimo,12612,10494,2118,0,0,0
2007,Nuevo Le¢n,Menos de 1 s.m.,148964,139074,9890,0,0,0
2007,Nuevo Le¢n,M s de 1 hasta 2 s.m.,38749,30216,8533,0,0,0
2007,Nuevo Le¢n,M s de 10 s.m.,1200172,571119,629053,0,0,0
2007,Nuevo Le¢n,M s de 2 hasta 3 s.m.,787430,762963,24467,0,0,0
2007,Nuevo Le¢n,M s de 3 hasta 5 s.m.,1771788,1252663,519125,0,0,0
2007,Nuevo Le¢n,M s de 5 hasta 10 s.m.,324729,229549,95180,0,0,0
2007,Nuevo Le¢n,No especificado,76684,52301,24383,0,0,0
2007,Nuevo Le¢n,No recibe ingresos,410526,374769,35757,0,0,0
2007,Oaxaca,1 salario m¡nimo,5930,5882,48,0,0,0
2007,Oaxaca,Menos de 1 s.m.,2007167,1612914,394253,0,0,0
2007,Oaxaca,M s de 1 hasta 2 s.m.,3723,2462,1261,0,0,0
2007,Oaxaca,M s de 10 s.m.,806479,270730,535749,0,0,0
2007,Oaxaca,M s de 2 hasta 3 s.m.,434477,423367,11110,0,0,0
2007,Oaxaca,M s de 3 hasta 5 s.m.,694727,257083,437644,0,0,0
2007,Oaxaca,M s de 5 hasta 10 s.m.,91354,64917,26437,0,0,0
2007,Oaxaca,No especificado,19004,11824,7180,0,0,0
2007,Oaxaca,No recibe ingresos,146294,142504,3790,0,0,0
2007,Puebla,1 salario m¡nimo,43832,42465,1367,0,0,0
2007,Puebla,Menos de 1 s.m.,2172978,1609309,563669,0,0,0
2007,Puebla,M s de 1 hasta 2 s.m.,18031,12984,5047,0,0,0
2007,Puebla,M s de 10 s.m.,1588235,669603,918632,0,0,0
2007,Puebla,M s de 2 hasta 3 s.m.,633128,618316,14812,0,0,0
2007,Puebla,M s de 3 hasta 5 s.m.,1764363,922677,841686,0,0,0
2007,Puebla,M s de 5 hasta 10 s.m.,203288,135859,67429,0,0,0
2007,Puebla,No especificado,40286,24883,15403,0,0,0
2007,Puebla,No recibe ingresos,279933,259795,20138,0,0,0
2007,Queretaro,1 salario m¡nimo,4386,4224,162,0,0,0
2007,Queretaro,Menos de 1 s.m.,221232,196428,24804,0,0,0
2007,Queretaro,M s de 1 hasta 2 s.m.,7609,6321,1288,0,0,0
2007,Queretaro,M s de 10 s.m.,466210,204699,261511,0,0,0
2007,Queretaro,M s de 2 hasta 3 s.m.,286375,275275,11100,0,0,0
2007,Queretaro,M s de 3 hasta 5 s.m.,620652,379452,241200,0,0,0
2007,Queretaro,M s de 5 hasta 10 s.m.,79811,59310,20501,0,0,0
2007,Queretaro,No especificado,29696,16174,13522,0,0,0
2007,Queretaro,No recibe ingresos,109874,100354,9520,0,0,0
2007,Quintana Roo,1 salario m¡nimo,2818,2493,325,0,0,0
2007,Quintana Roo,Menos de 1 s.m.,130018,116612,13406,0,0,0
2007,Quintana Roo,M s de 1 hasta 2 s.m.,14088,11868,2220,0,0,0
2007,Quintana Roo,M s de 10 s.m.,408437,176419,232018,0,0,0
2007,Quintana Roo,M s de 2 hasta 3 s.m.,244251,231152,13099,0,0,0
2007,Quintana Roo,M s de 3 hasta 5 s.m.,158505,96958,61547,0,0,0
2007,Quintana Roo,M s de 5 hasta 10 s.m.,48844,36921,11923,0,0,0
2007,Quintana Roo,No especificado,22543,17197,5346,0,0,0
2007,Quintana Roo,No recibe ingresos,126602,119064,7538,0,0,0
2007,San Luis Potos¡,1 salario m¡nimo,21880,21370,510,0,0,0
2007,San Luis Potos¡,Menos de 1 s.m.,808131,708943,99188,0,0,0
2007,San Luis Potos¡,M s de 1 hasta 2 s.m.,12197,10576,1621,0,0,0
2007,San Luis Potos¡,M s de 10 s.m.,599907,250891,349016,0,0,0
2007,San Luis Potos¡,M s de 2 hasta 3 s.m.,291510,282359,9151,0,0,0
2007,San Luis Potos¡,M s de 3 hasta 5 s.m.,677089,424531,252558,0,0,0
2007,San Luis Potos¡,M s de 5 hasta 10 s.m.,124735,91391,33344,0,0,0
2007,San Luis Potos¡,No especificado,22408,12397,10011,0,0,0
2007,San Luis Potos¡,No recibe ingresos,113706,102163,11543,0,0,0
2007,Sinaloa,1 salario m¡nimo,12931,12750,181,0,0,0
2007,Sinaloa,Menos de 1 s.m.,914063,798982,115081,0,0,0
2007,Sinaloa,M s de 1 hasta 2 s.m.,27279,22734,4545,0,0,0
2007,Sinaloa,M s de 10 s.m.,829185,353156,476029,0,0,0
2007,Sinaloa,M s de 2 hasta 3 s.m.,337278,326571,10707,0,0,0
2007,Sinaloa,M s de 3 hasta 5 s.m.,481895,292635,189260,0,0,0
2007,Sinaloa,M s de 5 hasta 10 s.m.,144042,99063,44979,0,0,0
2007,Sinaloa,No especificado,33333,25417,7916,0,0,0
2007,Sinaloa,No recibe ingresos,123666,116009,7657,0,0,0
2007,Sonora,1 salario m¡nimo,30819,30592,227,0,0,0
2007,Sonora,Menos de 1 s.m.,434920,378388,56532,0,0,0
2007,Sonora,M s de 1 hasta 2 s.m.,23320,18695,4625,0,0,0
2007,Sonora,M s de 10 s.m.,665953,321457,344496,0,0,0
2007,Sonora,M s de 2 hasta 3 s.m.,394543,377222,17321,0,0,0
2007,Sonora,M s de 3 hasta 5 s.m.,714930,392963,321967,0,0,0
2007,Sonora,M s de 5 hasta 10 s.m.,116042,74255,41787,0,0,0
2007,Sonora,No especificado,43126,28071,15055,0,0,0
2007,Sonora,No recibe ingresos,127481,119606,7875,0,0,0
2007,Tabasco,1 salario m¡nimo,167595,142847,24748,0,0,0
2007,Tabasco,Menos de 1 s.m.,549025,527298,21727,0,0,0
2007,Tabasco,M s de 1 hasta 2 s.m.,18214,16156,2058,0,0,0
2007,Tabasco,M s de 10 s.m.,523869,247152,276717,0,0,0
2007,Tabasco,M s de 2 hasta 3 s.m.,265715,260548,5167,0,0,0
2007,Tabasco,M s de 3 hasta 5 s.m.,260609,159542,101067,0,0,0
2007,Tabasco,M s de 5 hasta 10 s.m.,78520,57662,20858,0,0,0
2007,Tabasco,No especificado,21940,14410,7530,0,0,0
2007,Tabasco,No recibe ingresos,111925,106906,5019,0,0,0
2007,Tamaulipas,1 salario m¡nimo,50379,41888,8491,0,0,0
2007,Tamaulipas,Menos de 1 s.m.,375227,348408,26819,0,0,0
2007,Tamaulipas,M s de 1 hasta 2 s.m.,47872,36212,11660,0,0,0
2007,Tamaulipas,M s de 10 s.m.,930122,460097,470025,0,0,0
2007,Tamaulipas,M s de 2 hasta 3 s.m.,505581,493210,12371,0,0,0
2007,Tamaulipas,M s de 3 hasta 5 s.m.,984655,579566,405089,0,0,0
2007,Tamaulipas,M s de 5 hasta 10 s.m.,155193,118274,36919,0,0,0
2007,Tamaulipas,No especificado,45694,33095,12599,0,0,0
2007,Tamaulipas,No recibe ingresos,250359,223753,26606,0,0,0
2007,Tlaxcala,1 salario m¡nimo,851,772,79,0,0,0
2007,Tlaxcala,Menos de 1 s.m.,260676,230602,30074,0,0,0
2007,Tlaxcala,M s de 1 hasta 2 s.m.,4202,3712,490,0,0,0
2007,Tlaxcala,M s de 10 s.m.,294735,129606,165129,0,0,0
2007,Tlaxcala,M s de 2 hasta 3 s.m.,167254,163678,3576,0,0,0
2007,Tlaxcala,M s de 3 hasta 5 s.m.,428335,248253,180082,0,0,0
2007,Tlaxcala,M s de 5 hasta 10 s.m.,29202,23690,5512,0,0,0
2007,Tlaxcala,No especificado,4301,2677,1624,0,0,0
2007,Tlaxcala,No recibe ingresos,59117,57163,1954,0,0,0
2007,Veracruz,1 salario m¡nimo,114451,92355,22096,0,0,0
2007,Veracruz,Menos de 1 s.m.,2824739,2590190,234549,0,0,0
2007,Veracruz,M s de 1 hasta 2 s.m.,70656,63670,6986,0,0,0
2007,Veracruz,M s de 10 s.m.,1983759,854802,1128957,0,0,0
2007,Veracruz,M s de 2 hasta 3 s.m.,1034953,996432,38521,0,0,0
2007,Veracruz,M s de 3 hasta 5 s.m.,1332177,874489,457688,0,0,0
2007,Veracruz,M s de 5 hasta 10 s.m.,166847,133733,33114,0,0,0
2007,Veracruz,No especificado,55435,35451,19984,0,0,0
2007,Veracruz,No recibe ingresos,485106,445328,39778,0,0,0
2007,Yucat n,1 salario m¡nimo,4072,3612,460,0,0,0
2007,Yucat n,Menos de 1 s.m.,408086,372190,35896,0,0,0
2007,Yucat n,M s de 1 hasta 2 s.m.,16643,12384,4259,0,0,0
2007,Yucat n,M s de 10 s.m.,503966,219608,284358,0,0,0
2007,Yucat n,M s de 2 hasta 3 s.m.,315112,308665,6447,0,0,0
2007,Yucat n,M s de 3 hasta 5 s.m.,684621,338151,346470,0,0,0
2007,Yucat n,M s de 5 hasta 10 s.m.,88818,70066,18752,0,0,0
2007,Yucat n,No especificado,20136,13780,6356,0,0,0
2007,Yucat n,No recibe ingresos,122688,116061,6627,0,0,0
2007,Zacatecas,1 salario m¡nimo,15034,14339,695,0,0,0
2007,Zacatecas,Menos de 1 s.m.,579481,475970,103511,0,0,0
2007,Zacatecas,M s de 1 hasta 2 s.m.,4986,4889,97,0,0,0
2007,Zacatecas,M s de 10 s.m.,387988,147379,240609,0,0,0
2007,Zacatecas,M s de 2 hasta 3 s.m.,213910,211766,2144,0,0,0
2007,Zacatecas,M s de 3 hasta 5 s.m.,190852,122278,68574,0,0,0
2007,Zacatecas,M s de 5 hasta 10 s.m.,46038,35451,10587,0,0,0
2007,Zacatecas,No especificado,9956,5115,4841,0,0,0
2007,Zacatecas,No recibe ingresos,36420,35387,1033,0,0,0
2008,Aguascalientes,1 salario m¡nimo,4037,3810,227,0,0,0
2008,Aguascalientes,Menos de 1 s.m.,104727,99173,5554,0,0,0
2008,Aguascalientes,M s de 1 hasta 2 s.m.,5618,4279,1339,0,0,0
2008,Aguascalientes,M s de 10 s.m.,299538,146741,152797,0,0,0
2008,Aguascalientes,M s de 2 hasta 3 s.m.,140650,136786,3864,0,0,0
2008,Aguascalientes,M s de 3 hasta 5 s.m.,362918,242126,120792,0,0,0
2008,Aguascalientes,M s de 5 hasta 10 s.m.,52333,42820,9513,0,0,0
2008,Aguascalientes,No especificado,9947,6515,3432,0,0,0
2008,Aguascalientes,No recibe ingresos,60259,56916,3343,0,0,0
2008,Baja California,1 salario m¡nimo,4065,4065,0,0,0,0
2008,Baja California,Menos de 1 s.m.,292333,224042,68291,0,0,0
2008,Baja California,M s de 1 hasta 2 s.m.,19938,13567,6371,0,0,0
2008,Baja California,M s de 10 s.m.,903765,476036,427729,0,0,0
2008,Baja California,M s de 2 hasta 3 s.m.,456652,433304,23348,0,0,0
2008,Baja California,M s de 3 hasta 5 s.m.,1076055,612580,463475,0,0,0
2008,Baja California,M s de 5 hasta 10 s.m.,117195,81836,35359,0,0,0
2008,Baja California,No especificado,32502,21144,11358,0,0,0
2008,Baja California,No recibe ingresos,191267,167378,23889,0,0,0
2008,Baja California Sur,1 salario m¡nimo,5545,5334,211,0,0,0
2008,Baja California Sur,Menos de 1 s.m.,98004,76594,21410,0,0,0
2008,Baja California Sur,M s de 1 hasta 2 s.m.,12026,9676,2350,0,0,0
2008,Baja California Sur,M s de 10 s.m.,191750,93515,98235,0,0,0
2008,Baja California Sur,M s de 2 hasta 3 s.m.,145976,137026,8950,0,0,0
2008,Baja California Sur,M s de 3 hasta 5 s.m.,75426,50564,24862,0,0,0
2008,Baja California Sur,M s de 5 hasta 10 s.m.,24286,17429,6857,0,0,0
2008,Baja California Sur,No especificado,6380,3122,3258,0,0,0
2008,Baja California Sur,No recibe ingresos,43192,39148,4044,0,0,0
2008,Campeche,1 salario m¡nimo,39704,33555,6149,0,0,0
2008,Campeche,Menos de 1 s.m.,264140,247570,16570,0,0,0
2008,Campeche,M s de 1 hasta 2 s.m.,5425,4385,1040,0,0,0
2008,Campeche,M s de 10 s.m.,212244,94326,117918,0,0,0
2008,Campeche,M s de 2 hasta 3 s.m.,120327,114507,5820,0,0,0
2008,Campeche,M s de 3 hasta 5 s.m.,126656,67588,59068,0,0,0
2008,Campeche,M s de 5 hasta 10 s.m.,18140,14941,3199,0,0,0
2008,Campeche,No especificado,9262,6454,2808,0,0,0
2008,Campeche,No recibe ingresos,52900,50199,2701,0,0,0
2008,Chiapas,1 salario m¡nimo,6398,6338,60,0,0,0
2008,Chiapas,Menos de 1 s.m.,2634968,2516593,118375,0,0,0
2008,Chiapas,M s de 1 hasta 2 s.m.,26318,23660,2658,0,0,0
2008,Chiapas,M s de 10 s.m.,912228,311354,600874,0,0,0
2008,Chiapas,M s de 2 hasta 3 s.m.,448506,437902,10604,0,0,0
2008,Chiapas,M s de 3 hasta 5 s.m.,464216,247146,217070,0,0,0
2008,Chiapas,M s de 5 hasta 10 s.m.,158885,130175,28710,0,0,0
2008,Chiapas,No especificado,16178,10483,5695,0,0,0
2008,Chiapas,No recibe ingresos,229041,224495,4546,0,0,0
2008,Chihuahua,1 salario m¡nimo,10285,9447,838,0,0,0
2008,Chihuahua,Menos de 1 s.m.,531873,508850,23023,0,0,0
2008,Chihuahua,M s de 1 hasta 2 s.m.,28310,25746,2564,0,0,0
2008,Chihuahua,M s de 10 s.m.,952303,523639,428664,0,0,0
2008,Chihuahua,M s de 2 hasta 3 s.m.,435558,422689,12869,0,0,0
2008,Chihuahua,M s de 3 hasta 5 s.m.,1193968,733576,460392,0,0,0
2008,Chihuahua,M s de 5 hasta 10 s.m.,120870,95032,25838,0,0,0
2008,Chihuahua,No especificado,49426,37150,12276,0,0,0
2008,Chihuahua,No recibe ingresos,142908,127821,15087,0,0,0
2008,Ciudad de Mxico,1 salario m¡nimo,6587,6587,0,0,0,0
2008,Ciudad de Mxico,Menos de 1 s.m.,101724,79510,22214,0,0,0
2008,Ciudad de Mxico,M s de 1 hasta 2 s.m.,102499,86628,15871,0,0,0
2008,Ciudad de Mxico,M s de 10 s.m.,2872567,1411811,1460756,0,0,0
2008,Ciudad de Mxico,M s de 2 hasta 3 s.m.,846100,789321,56779,0,0,0
2008,Ciudad de Mxico,M s de 3 hasta 5 s.m.,2172448,1410549,761899,0,0,0
2008,Ciudad de Mxico,M s de 5 hasta 10 s.m.,542936,384842,158094,0,0,0
2008,Ciudad de Mxico,No especificado,352552,229136,123416,0,0,0
2008,Ciudad de Mxico,No recibe ingresos,871927,769739,102188,0,0,0
2008,Coahuila,1 salario m¡nimo,58669,56404,2265,0,0,0
2008,Coahuila,Menos de 1 s.m.,210021,193827,16194,0,0,0
2008,Coahuila,M s de 1 hasta 2 s.m.,28116,24297,3819,0,0,0
2008,Coahuila,M s de 10 s.m.,735631,331844,403787,0,0,0
2008,Coahuila,M s de 2 hasta 3 s.m.,398654,381917,16737,0,0,0
2008,Coahuila,M s de 3 hasta 5 s.m.,961880,694766,267114,0,0,0
2008,Coahuila,M s de 5 hasta 10 s.m.,153344,122625,30719,0,0,0
2008,Coahuila,No especificado,34758,16450,18308,0,0,0
2008,Coahuila,No recibe ingresos,163075,154482,8593,0,0,0
2008,Colima,1 salario m¡nimo,9909,9439,470,0,0,0
2008,Colima,Menos de 1 s.m.,151909,127870,24039,0,0,0
2008,Colima,M s de 1 hasta 2 s.m.,7486,6051,1435,0,0,0
2008,Colima,M s de 10 s.m.,194030,74466,119564,0,0,0
2008,Colima,M s de 2 hasta 3 s.m.,108306,103781,4525,0,0,0
2008,Colima,M s de 3 hasta 5 s.m.,99108,59711,39397,0,0,0
2008,Colima,M s de 5 hasta 10 s.m.,30418,21361,9057,0,0,0
2008,Colima,No especificado,11579,7633,3946,0,0,0
2008,Colima,No recibe ingresos,73232,62614,10618,0,0,0
2008,Durango,1 salario m¡nimo,53707,49365,4342,0,0,0
2008,Durango,Menos de 1 s.m.,388411,370547,17864,0,0,0
2008,Durango,M s de 1 hasta 2 s.m.,7852,6499,1353,0,0,0
2008,Durango,M s de 10 s.m.,397794,177890,219904,0,0,0
2008,Durango,M s de 2 hasta 3 s.m.,182206,180277,1929,0,0,0
2008,Durango,M s de 3 hasta 5 s.m.,333104,228439,104665,0,0,0
2008,Durango,M s de 5 hasta 10 s.m.,55946,40904,15042,0,0,0
2008,Durango,No especificado,11239,6883,4356,0,0,0
2008,Durango,No recibe ingresos,118320,113918,4402,0,0,0
2008,Estado de Mxico,1 salario m¡nimo,13132,13046,86,0,0,0
2008,Estado de Mxico,Menos de 1 s.m.,1333374,1176490,156884,0,0,0
2008,Estado de Mxico,M s de 1 hasta 2 s.m.,118217,111045,7172,0,0,0
2008,Estado de Mxico,M s de 10 s.m.,4136660,1990446,2146214,0,0,0
2008,Estado de Mxico,M s de 2 hasta 3 s.m.,2259277,2195078,64199,0,0,0
2008,Estado de Mxico,M s de 3 hasta 5 s.m.,4382703,2839297,1543406,0,0,0
2008,Estado de Mxico,M s de 5 hasta 10 s.m.,663705,504923,158782,0,0,0
2008,Estado de Mxico,No especificado,231593,134882,96711,0,0,0
2008,Estado de Mxico,No recibe ingresos,1616461,1528267,88194,0,0,0
2008,Guanajuato,1 salario m¡nimo,14622,13434,1188,0,0,0
2008,Guanajuato,Menos de 1 s.m.,990239,854157,136082,0,0,0
2008,Guanajuato,M s de 1 hasta 2 s.m.,27101,25301,1800,0,0,0
2008,Guanajuato,M s de 10 s.m.,1478742,643349,835393,0,0,0
2008,Guanajuato,M s de 2 hasta 3 s.m.,664545,645881,18664,0,0,0
2008,Guanajuato,M s de 3 hasta 5 s.m.,2000072,1285305,714767,0,0,0
2008,Guanajuato,M s de 5 hasta 10 s.m.,242956,184205,58751,0,0,0
2008,Guanajuato,No especificado,33690,22713,10977,0,0,0
2008,Guanajuato,No recibe ingresos,220804,200344,20460,0,0,0
2008,Guerrero,1 salario m¡nimo,10627,10106,521,0,0,0
2008,Guerrero,Menos de 1 s.m.,1410828,1184374,226454,0,0,0
2008,Guerrero,M s de 1 hasta 2 s.m.,30022,25814,4208,0,0,0
2008,Guerrero,M s de 10 s.m.,854743,282707,572036,0,0,0
2008,Guerrero,M s de 2 hasta 3 s.m.,347491,338000,9491,0,0,0
2008,Guerrero,M s de 3 hasta 5 s.m.,545419,222686,322733,0,0,0
2008,Guerrero,M s de 5 hasta 10 s.m.,80485,64740,15745,0,0,0
2008,Guerrero,No especificado,21742,13894,7848,0,0,0
2008,Guerrero,No recibe ingresos,215045,209016,6029,0,0,0
2008,Hidalgo,1 salario m¡nimo,16011,14839,1172,0,0,0
2008,Hidalgo,Menos de 1 s.m.,923221,742986,180235,0,0,0
2008,Hidalgo,M s de 1 hasta 2 s.m.,18353,14327,4026,0,0,0
2008,Hidalgo,M s de 10 s.m.,605547,274934,330613,0,0,0
2008,Hidalgo,M s de 2 hasta 3 s.m.,341695,333994,7701,0,0,0
2008,Hidalgo,M s de 3 hasta 5 s.m.,605820,341974,263846,0,0,0
2008,Hidalgo,M s de 5 hasta 10 s.m.,107549,89246,18303,0,0,0
2008,Hidalgo,No especificado,18555,10425,8130,0,0,0
2008,Hidalgo,No recibe ingresos,131278,126286,4992,0,0,0
2008,Jalisco,1 salario m¡nimo,7600,7600,0,0,0,0
2008,Jalisco,Menos de 1 s.m.,1111687,984845,126842,0,0,0
2008,Jalisco,M s de 1 hasta 2 s.m.,37327,29439,7888,0,0,0
2008,Jalisco,M s de 10 s.m.,2287313,1030395,1256918,0,0,0
2008,Jalisco,M s de 2 hasta 3 s.m.,1068106,1030868,37238,0,0,0
2008,Jalisco,M s de 3 hasta 5 s.m.,2372813,1519156,853657,0,0,0
2008,Jalisco,M s de 5 hasta 10 s.m.,393948,291391,102557,0,0,0
2008,Jalisco,No especificado,76689,42586,34103,0,0,0
2008,Jalisco,No recibe ingresos,363066,328616,34450,0,0,0
2008,Michoac n,1 salario m¡nimo,3741,3741,0,0,0,0
2008,Michoac n,Menos de 1 s.m.,1409655,1253033,156622,0,0,0
2008,Michoac n,M s de 1 hasta 2 s.m.,26138,18756,7382,0,0,0
2008,Michoac n,M s de 10 s.m.,1308343,530561,777782,0,0,0
2008,Michoac n,M s de 2 hasta 3 s.m.,497209,489825,7384,0,0,0
2008,Michoac n,M s de 3 hasta 5 s.m.,960108,621131,338977,0,0,0
2008,Michoac n,M s de 5 hasta 10 s.m.,164550,139579,24971,0,0,0
2008,Michoac n,No especificado,31087,15958,15129,0,0,0
2008,Michoac n,No recibe ingresos,215927,197383,18544,0,0,0
2008,Morelos,1 salario m¡nimo,7428,7428,0,0,0,0
2008,Morelos,Menos de 1 s.m.,408698,365399,43299,0,0,0
2008,Morelos,M s de 1 hasta 2 s.m.,17341,15520,1821,0,0,0
2008,Morelos,M s de 10 s.m.,566953,237643,329310,0,0,0
2008,Morelos,M s de 2 hasta 3 s.m.,288553,283244,5309,0,0,0
2008,Morelos,M s de 3 hasta 5 s.m.,324824,194812,130012,0,0,0
2008,Morelos,M s de 5 hasta 10 s.m.,54508,42559,11949,0,0,0
2008,Morelos,No especificado,15980,9310,6670,0,0,0
2008,Morelos,No recibe ingresos,109085,100672,8413,0,0,0
2008,Nacional,1 salario m¡nimo,769218,690228,78990,0,0,0
2008,Nacional,Menos de 1 s.m.,24454410,21490859,2963551,0,0,0
2008,Nacional,M s de 1 hasta 2 s.m.,847638,709440,138198,0,0,0
2008,Nacional,M s de 10 s.m.,30696959,13800752,16896207,0,0,0
2008,Nacional,M s de 2 hasta 3 s.m.,14928701,14444754,483947,0,0,0
2008,Nacional,M s de 3 hasta 5 s.m.,28644363,17715426,10928937,0,0,0
2008,Nacional,M s de 5 hasta 10 s.m.,4691201,3522989,1168212,0,0,0
2008,Nacional,No especificado,1427113,902529,524584,0,0,0
2008,Nacional,No recibe ingresos,7520846,6957355,563491,0,0,0
2008,Nayarit,1 salario m¡nimo,3681,3237,444,0,0,0
2008,Nayarit,Menos de 1 s.m.,338239,319353,18886,0,0,0
2008,Nayarit,M s de 1 hasta 2 s.m.,7905,6392,1513,0,0,0
2008,Nayarit,M s de 10 s.m.,317110,118146,198964,0,0,0
2008,Nayarit,M s de 2 hasta 3 s.m.,158317,154161,4156,0,0,0
2008,Nayarit,M s de 3 hasta 5 s.m.,167743,102629,65114,0,0,0
2008,Nayarit,M s de 5 hasta 10 s.m.,31418,23040,8378,0,0,0
2008,Nayarit,No especificado,6812,3606,3206,0,0,0
2008,Nayarit,No recibe ingresos,58067,53550,4517,0,0,0
2008,Nuevo Le¢n,1 salario m¡nimo,9812,7233,2579,0,0,0
2008,Nuevo Le¢n,Menos de 1 s.m.,141287,130896,10391,0,0,0
2008,Nuevo Le¢n,M s de 1 hasta 2 s.m.,43005,34729,8276,0,0,0
2008,Nuevo Le¢n,M s de 10 s.m.,1227063,579984,647079,0,0,0
2008,Nuevo Le¢n,M s de 2 hasta 3 s.m.,773601,751075,22526,0,0,0
2008,Nuevo Le¢n,M s de 3 hasta 5 s.m.,1819417,1262494,556923,0,0,0
2008,Nuevo Le¢n,M s de 5 hasta 10 s.m.,324681,237592,87089,0,0,0
2008,Nuevo Le¢n,No especificado,88951,62046,26905,0,0,0
2008,Nuevo Le¢n,No recibe ingresos,432655,398662,33993,0,0,0
2008,Oaxaca,1 salario m¡nimo,6502,6401,101,0,0,0
2008,Oaxaca,Menos de 1 s.m.,1937243,1597983,339260,0,0,0
2008,Oaxaca,M s de 1 hasta 2 s.m.,8989,7002,1987,0,0,0
2008,Oaxaca,M s de 10 s.m.,880976,305312,575664,0,0,0
2008,Oaxaca,M s de 2 hasta 3 s.m.,455673,449211,6462,0,0,0
2008,Oaxaca,M s de 3 hasta 5 s.m.,696976,257676,439300,0,0,0
2008,Oaxaca,M s de 5 hasta 10 s.m.,78360,53949,24411,0,0,0
2008,Oaxaca,No especificado,16312,9721,6591,0,0,0
2008,Oaxaca,No recibe ingresos,196779,188409,8370,0,0,0
2008,Puebla,1 salario m¡nimo,30537,29346,1191,0,0,0
2008,Puebla,Menos de 1 s.m.,2243648,1730092,513556,0,0,0
2008,Puebla,M s de 1 hasta 2 s.m.,23580,19206,4374,0,0,0
2008,Puebla,M s de 10 s.m.,1477129,643593,833536,0,0,0
2008,Puebla,M s de 2 hasta 3 s.m.,653808,642071,11737,0,0,0
2008,Puebla,M s de 3 hasta 5 s.m.,1645238,905414,739824,0,0,0
2008,Puebla,M s de 5 hasta 10 s.m.,240328,161948,78380,0,0,0
2008,Puebla,No especificado,35536,23518,12018,0,0,0
2008,Puebla,No recibe ingresos,272020,261443,10577,0,0,0
2008,Queretaro,1 salario m¡nimo,5163,5014,149,0,0,0
2008,Queretaro,Menos de 1 s.m.,237492,205602,31890,0,0,0
2008,Queretaro,M s de 1 hasta 2 s.m.,11264,9517,1747,0,0,0
2008,Queretaro,M s de 10 s.m.,439345,182373,256972,0,0,0
2008,Queretaro,M s de 2 hasta 3 s.m.,282855,271032,11823,0,0,0
2008,Queretaro,M s de 3 hasta 5 s.m.,597934,378835,219099,0,0,0
2008,Queretaro,M s de 5 hasta 10 s.m.,89795,65326,24469,0,0,0
2008,Queretaro,No especificado,24940,15301,9639,0,0,0
2008,Queretaro,No recibe ingresos,112904,105763,7141,0,0,0
2008,Quintana Roo,1 salario m¡nimo,5147,5147,0,0,0,0
2008,Quintana Roo,Menos de 1 s.m.,135082,122148,12934,0,0,0
2008,Quintana Roo,M s de 1 hasta 2 s.m.,7341,6096,1245,0,0,0
2008,Quintana Roo,M s de 10 s.m.,425907,177493,248414,0,0,0
2008,Quintana Roo,M s de 2 hasta 3 s.m.,263203,249061,14142,0,0,0
2008,Quintana Roo,M s de 3 hasta 5 s.m.,153804,93599,60205,0,0,0
2008,Quintana Roo,M s de 5 hasta 10 s.m.,41732,30800,10932,0,0,0
2008,Quintana Roo,No especificado,28290,18293,9997,0,0,0
2008,Quintana Roo,No recibe ingresos,139537,127509,12028,0,0,0
2008,San Luis Potos¡,1 salario m¡nimo,24083,23008,1075,0,0,0
2008,San Luis Potos¡,Menos de 1 s.m.,796688,695901,100787,0,0,0
2008,San Luis Potos¡,M s de 1 hasta 2 s.m.,17805,13472,4333,0,0,0
2008,San Luis Potos¡,M s de 10 s.m.,624246,270463,353783,0,0,0
2008,San Luis Potos¡,M s de 2 hasta 3 s.m.,303568,293541,10027,0,0,0
2008,San Luis Potos¡,M s de 3 hasta 5 s.m.,652159,420520,231639,0,0,0
2008,San Luis Potos¡,M s de 5 hasta 10 s.m.,112662,81519,31143,0,0,0
2008,San Luis Potos¡,No especificado,16914,10392,6522,0,0,0
2008,San Luis Potos¡,No recibe ingresos,138399,128970,9429,0,0,0
2008,Sinaloa,1 salario m¡nimo,13889,13393,496,0,0,0
2008,Sinaloa,Menos de 1 s.m.,887211,779816,107395,0,0,0
2008,Sinaloa,M s de 1 hasta 2 s.m.,30073,25068,5005,0,0,0
2008,Sinaloa,M s de 10 s.m.,864912,382357,482555,0,0,0
2008,Sinaloa,M s de 2 hasta 3 s.m.,391892,375131,16761,0,0,0
2008,Sinaloa,M s de 3 hasta 5 s.m.,470809,304040,166769,0,0,0
2008,Sinaloa,M s de 5 hasta 10 s.m.,135768,95980,39788,0,0,0
2008,Sinaloa,No especificado,31123,17403,13720,0,0,0
2008,Sinaloa,No recibe ingresos,128270,121025,7245,0,0,0
2008,Sonora,1 salario m¡nimo,28723,26499,2224,0,0,0
2008,Sonora,Menos de 1 s.m.,439315,383230,56085,0,0,0
2008,Sonora,M s de 1 hasta 2 s.m.,17887,11935,5952,0,0,0
2008,Sonora,M s de 10 s.m.,726818,341256,385562,0,0,0
2008,Sonora,M s de 2 hasta 3 s.m.,384116,372089,12027,0,0,0
2008,Sonora,M s de 3 hasta 5 s.m.,747064,411274,335790,0,0,0
2008,Sonora,M s de 5 hasta 10 s.m.,117288,83237,34051,0,0,0
2008,Sonora,No especificado,35866,24781,11085,0,0,0
2008,Sonora,No recibe ingresos,135892,122571,13321,0,0,0
2008,Tabasco,1 salario m¡nimo,160539,136451,24088,0,0,0
2008,Tabasco,Menos de 1 s.m.,577105,554622,22483,0,0,0
2008,Tabasco,M s de 1 hasta 2 s.m.,15905,12459,3446,0,0,0
2008,Tabasco,M s de 10 s.m.,569374,285843,283531,0,0,0
2008,Tabasco,M s de 2 hasta 3 s.m.,259716,254714,5002,0,0,0
2008,Tabasco,M s de 3 hasta 5 s.m.,263569,171746,91823,0,0,0
2008,Tabasco,M s de 5 hasta 10 s.m.,89168,76075,13093,0,0,0
2008,Tabasco,No especificado,22450,15557,6893,0,0,0
2008,Tabasco,No recibe ingresos,136340,130694,5646,0,0,0
2008,Tamaulipas,1 salario m¡nimo,59476,48593,10883,0,0,0
2008,Tamaulipas,Menos de 1 s.m.,343166,323804,19362,0,0,0
2008,Tamaulipas,M s de 1 hasta 2 s.m.,38878,33558,5320,0,0,0
2008,Tamaulipas,M s de 10 s.m.,968610,462295,506315,0,0,0
2008,Tamaulipas,M s de 2 hasta 3 s.m.,556529,534968,21561,0,0,0
2008,Tamaulipas,M s de 3 hasta 5 s.m.,960851,585753,375098,0,0,0
2008,Tamaulipas,M s de 5 hasta 10 s.m.,141663,104016,37647,0,0,0
2008,Tamaulipas,No especificado,53923,37646,16277,0,0,0
2008,Tamaulipas,No recibe ingresos,250946,214699,36247,0,0,0
2008,Tlaxcala,1 salario m¡nimo,1468,1468,0,0,0,0
2008,Tlaxcala,Menos de 1 s.m.,281316,243419,37897,0,0,0
2008,Tlaxcala,M s de 1 hasta 2 s.m.,4064,3547,517,0,0,0
2008,Tlaxcala,M s de 10 s.m.,301916,132545,169371,0,0,0
2008,Tlaxcala,M s de 2 hasta 3 s.m.,163457,161559,1898,0,0,0
2008,Tlaxcala,M s de 3 hasta 5 s.m.,414710,240623,174087,0,0,0
2008,Tlaxcala,M s de 5 hasta 10 s.m.,22207,16760,5447,0,0,0
2008,Tlaxcala,No especificado,5436,2430,3006,0,0,0
2008,Tlaxcala,No recibe ingresos,51720,50391,1329,0,0,0
2008,Veracruz,1 salario m¡nimo,117842,100582,17260,0,0,0
2008,Veracruz,Menos de 1 s.m.,2738757,2526254,212503,0,0,0
2008,Veracruz,M s de 1 hasta 2 s.m.,80739,64177,16562,0,0,0
2008,Veracruz,M s de 10 s.m.,2086822,915129,1171693,0,0,0
2008,Veracruz,M s de 2 hasta 3 s.m.,1002620,962849,39771,0,0,0
2008,Veracruz,M s de 3 hasta 5 s.m.,1123536,737445,386091,0,0,0
2008,Veracruz,M s de 5 hasta 10 s.m.,137375,107646,29729,0,0,0
2008,Veracruz,No especificado,64091,43864,20227,0,0,0
2008,Veracruz,No recibe ingresos,491832,447542,44290,0,0,0
2008,Yucat n,1 salario m¡nimo,6524,6256,268,0,0,0
2008,Yucat n,Menos de 1 s.m.,400750,370065,30685,0,0,0
2008,Yucat n,M s de 1 hasta 2 s.m.,18603,14346,4257,0,0,0
2008,Yucat n,M s de 10 s.m.,490234,216945,273289,0,0,0
2008,Yucat n,M s de 2 hasta 3 s.m.,326825,319300,7525,0,0,0
2008,Yucat n,M s de 3 hasta 5 s.m.,688888,355666,333222,0,0,0
2008,Yucat n,M s de 5 hasta 10 s.m.,100805,79413,21392,0,0,0
2008,Yucat n,No especificado,26112,19315,6797,0,0,0
2008,Yucat n,No recibe ingresos,124123,116688,7435,0,0,0
2008,Zacatecas,1 salario m¡nimo,23765,23062,703,0,0,0
2008,Zacatecas,Menos de 1 s.m.,591299,501814,89485,0,0,0
2008,Zacatecas,M s de 1 hasta 2 s.m.,3513,2946,567,0,0,0
2008,Zacatecas,M s de 10 s.m.,386346,155361,230985,0,0,0
2008,Zacatecas,M s de 2 hasta 3 s.m.,202710,199592,3118,0,0,0
2008,Zacatecas,M s de 3 hasta 5 s.m.,184127,116306,67821,0,0,0
2008,Zacatecas,M s de 5 hasta 10 s.m.,45897,37080,8817,0,0,0
2008,Zacatecas,No especificado,7198,3918,3280,0,0,0
2008,Zacatecas,No recibe ingresos,33575,32145,1430,0,0,0
2009,Aguascalientes,1 salario m¡nimo,4512,4326,186,0,0,0
2009,Aguascalientes,Menos de 1 s.m.,109388,103376,6012,0,0,0
2009,Aguascalientes,M s de 1 hasta 2 s.m.,6088,4622,1466,0,0,0
2009,Aguascalientes,M s de 10 s.m.,300755,148627,152128,0,0,0
2009,Aguascalientes,M s de 2 hasta 3 s.m.,143470,138788,4682,0,0,0
2009,Aguascalientes,M s de 3 hasta 5 s.m.,334744,222658,112086,0,0,0
2009,Aguascalientes,M s de 5 hasta 10 s.m.,50241,40336,9905,0,0,0
2009,Aguascalientes,No especificado,9158,4589,4569,0,0,0
2009,Aguascalientes,No recibe ingresos,59738,57047,2691,0,0,0
2009,Baja California,1 salario m¡nimo,5156,4827,329,0,0,0
2009,Baja California,Menos de 1 s.m.,336117,259595,76522,0,0,0
2009,Baja California,M s de 1 hasta 2 s.m.,29911,25242,4669,0,0,0
2009,Baja California,M s de 10 s.m.,956993,500348,456645,0,0,0
2009,Baja California,M s de 2 hasta 3 s.m.,371509,361391,10118,0,0,0
2009,Baja California,M s de 3 hasta 5 s.m.,1004356,583760,420596,0,0,0
2009,Baja California,M s de 5 hasta 10 s.m.,119225,86288,32937,0,0,0
2009,Baja California,No especificado,40666,24036,16630,0,0,0
2009,Baja California,No recibe ingresos,180790,158984,21806,0,0,0
2009,Baja California Sur,1 salario m¡nimo,8765,8446,319,0,0,0
2009,Baja California Sur,Menos de 1 s.m.,97687,82855,14832,0,0,0
2009,Baja California Sur,M s de 1 hasta 2 s.m.,11069,8525,2544,0,0,0
2009,Baja California Sur,M s de 10 s.m.,184299,91558,92741,0,0,0
2009,Baja California Sur,M s de 2 hasta 3 s.m.,118109,113011,5098,0,0,0
2009,Baja California Sur,M s de 3 hasta 5 s.m.,65480,41827,23653,0,0,0
2009,Baja California Sur,M s de 5 hasta 10 s.m.,25937,20743,5194,0,0,0
2009,Baja California Sur,No especificado,6045,3283,2762,0,0,0
2009,Baja California Sur,No recibe ingresos,44612,39997,4615,0,0,0
2009,Campeche,1 salario m¡nimo,35587,28697,6890,0,0,0
2009,Campeche,Menos de 1 s.m.,282433,259658,22775,0,0,0
2009,Campeche,M s de 1 hasta 2 s.m.,3770,3266,504,0,0,0
2009,Campeche,M s de 10 s.m.,205494,86489,119005,0,0,0
2009,Campeche,M s de 2 hasta 3 s.m.,117606,113253,4353,0,0,0
2009,Campeche,M s de 3 hasta 5 s.m.,123348,62641,60707,0,0,0
2009,Campeche,M s de 5 hasta 10 s.m.,17632,13246,4386,0,0,0
2009,Campeche,No especificado,8474,6051,2423,0,0,0
2009,Campeche,No recibe ingresos,59261,56452,2809,0,0,0
2009,Chiapas,1 salario m¡nimo,3368,3368,0,0,0,0
2009,Chiapas,Menos de 1 s.m.,2640555,2510529,130026,0,0,0
2009,Chiapas,M s de 1 hasta 2 s.m.,32918,26219,6699,0,0,0
2009,Chiapas,M s de 10 s.m.,1032910,332416,700494,0,0,0
2009,Chiapas,M s de 2 hasta 3 s.m.,474031,465579,8452,0,0,0
2009,Chiapas,M s de 3 hasta 5 s.m.,541775,317220,224555,0,0,0
2009,Chiapas,M s de 5 hasta 10 s.m.,158052,127826,30226,0,0,0
2009,Chiapas,No especificado,11825,7800,4025,0,0,0
2009,Chiapas,No recibe ingresos,222640,214015,8625,0,0,0
2009,Chihuahua,1 salario m¡nimo,12907,12005,902,0,0,0
2009,Chihuahua,Menos de 1 s.m.,575537,548979,26558,0,0,0
2009,Chihuahua,M s de 1 hasta 2 s.m.,23122,21326,1796,0,0,0
2009,Chihuahua,M s de 10 s.m.,883946,514471,369475,0,0,0
2009,Chihuahua,M s de 2 hasta 3 s.m.,439102,425719,13383,0,0,0
2009,Chihuahua,M s de 3 hasta 5 s.m.,1024663,647490,377173,0,0,0
2009,Chihuahua,M s de 5 hasta 10 s.m.,94511,64342,30169,0,0,0
2009,Chihuahua,No especificado,54337,40564,13773,0,0,0
2009,Chihuahua,No recibe ingresos,142334,123171,19163,0,0,0
2009,Ciudad de Mxico,1 salario m¡nimo,9993,7246,2747,0,0,0
2009,Ciudad de Mxico,Menos de 1 s.m.,53104,46602,6502,0,0,0
2009,Ciudad de Mxico,M s de 1 hasta 2 s.m.,102006,79673,22333,0,0,0
2009,Ciudad de Mxico,M s de 10 s.m.,2838228,1411128,1427100,0,0,0
2009,Ciudad de Mxico,M s de 2 hasta 3 s.m.,789913,735406,54507,0,0,0
2009,Ciudad de Mxico,M s de 3 hasta 5 s.m.,1850135,1187711,662424,0,0,0
2009,Ciudad de Mxico,M s de 5 hasta 10 s.m.,458558,328895,129663,0,0,0
2009,Ciudad de Mxico,No especificado,324638,206636,118002,0,0,0
2009,Ciudad de Mxico,No recibe ingresos,973562,874564,98998,0,0,0
2009,Coahuila,1 salario m¡nimo,57091,54327,2764,0,0,0
2009,Coahuila,Menos de 1 s.m.,244282,232851,11431,0,0,0
2009,Coahuila,M s de 1 hasta 2 s.m.,19004,14522,4482,0,0,0
2009,Coahuila,M s de 10 s.m.,780684,361385,419299,0,0,0
2009,Coahuila,M s de 2 hasta 3 s.m.,333592,318311,15281,0,0,0
2009,Coahuila,M s de 3 hasta 5 s.m.,867910,631863,236047,0,0,0
2009,Coahuila,M s de 5 hasta 10 s.m.,144462,111949,32513,0,0,0
2009,Coahuila,No especificado,44943,30365,14578,0,0,0
2009,Coahuila,No recibe ingresos,157250,148070,9180,0,0,0
2009,Colima,1 salario m¡nimo,7062,6944,118,0,0,0
2009,Colima,Menos de 1 s.m.,154466,132669,21797,0,0,0
2009,Colima,M s de 1 hasta 2 s.m.,8570,6969,1601,0,0,0
2009,Colima,M s de 10 s.m.,190802,69926,120876,0,0,0
2009,Colima,M s de 2 hasta 3 s.m.,100517,96201,4316,0,0,0
2009,Colima,M s de 3 hasta 5 s.m.,108692,67051,41641,0,0,0
2009,Colima,M s de 5 hasta 10 s.m.,23071,16633,6438,0,0,0
2009,Colima,No especificado,12646,7766,4880,0,0,0
2009,Colima,No recibe ingresos,69642,57799,11843,0,0,0
2009,Durango,1 salario m¡nimo,53505,49053,4452,0,0,0
2009,Durango,Menos de 1 s.m.,427111,413257,13854,0,0,0
2009,Durango,M s de 1 hasta 2 s.m.,13759,11603,2156,0,0,0
2009,Durango,M s de 10 s.m.,394454,149198,245256,0,0,0
2009,Durango,M s de 2 hasta 3 s.m.,175202,171256,3946,0,0,0
2009,Durango,M s de 3 hasta 5 s.m.,308590,215512,93078,0,0,0
2009,Durango,M s de 5 hasta 10 s.m.,47908,37727,10181,0,0,0
2009,Durango,No especificado,16660,8687,7973,0,0,0
2009,Durango,No recibe ingresos,113681,109012,4669,0,0,0
2009,Estado de Mxico,1 salario m¡nimo,31195,30863,332,0,0,0
2009,Estado de Mxico,Menos de 1 s.m.,1276226,1129148,147078,0,0,0
2009,Estado de Mxico,M s de 1 hasta 2 s.m.,131099,114723,16376,0,0,0
2009,Estado de Mxico,M s de 10 s.m.,4583448,2302868,2280580,0,0,0
2009,Estado de Mxico,M s de 2 hasta 3 s.m.,2197915,2131808,66107,0,0,0
2009,Estado de Mxico,M s de 3 hasta 5 s.m.,4198117,2781403,1416714,0,0,0
2009,Estado de Mxico,M s de 5 hasta 10 s.m.,657979,501298,156681,0,0,0
2009,Estado de Mxico,No especificado,255541,163986,91555,0,0,0
2009,Estado de Mxico,No recibe ingresos,1800680,1728856,71824,0,0,0
2009,Guanajuato,1 salario m¡nimo,14440,11962,2478,0,0,0
2009,Guanajuato,Menos de 1 s.m.,992905,860233,132672,0,0,0
2009,Guanajuato,M s de 1 hasta 2 s.m.,33677,31500,2177,0,0,0
2009,Guanajuato,M s de 10 s.m.,1556701,663649,893052,0,0,0
2009,Guanajuato,M s de 2 hasta 3 s.m.,603280,591551,11729,0,0,0
2009,Guanajuato,M s de 3 hasta 5 s.m.,1958263,1238192,720071,0,0,0
2009,Guanajuato,M s de 5 hasta 10 s.m.,229531,167523,62008,0,0,0
2009,Guanajuato,No especificado,41284,28070,13214,0,0,0
2009,Guanajuato,No recibe ingresos,214715,193137,21578,0,0,0
2009,Guerrero,1 salario m¡nimo,10226,9946,280,0,0,0
2009,Guerrero,Menos de 1 s.m.,1625031,1342761,282270,0,0,0
2009,Guerrero,M s de 1 hasta 2 s.m.,26190,21909,4281,0,0,0
2009,Guerrero,M s de 10 s.m.,889771,302161,587610,0,0,0
2009,Guerrero,M s de 2 hasta 3 s.m.,359189,350541,8648,0,0,0
2009,Guerrero,M s de 3 hasta 5 s.m.,553681,235081,318600,0,0,0
2009,Guerrero,M s de 5 hasta 10 s.m.,107887,92530,15357,0,0,0
2009,Guerrero,No especificado,26724,14060,12664,0,0,0
2009,Guerrero,No recibe ingresos,196131,192706,3425,0,0,0
2009,Hidalgo,1 salario m¡nimo,13134,11569,1565,0,0,0
2009,Hidalgo,Menos de 1 s.m.,991280,864799,126481,0,0,0
2009,Hidalgo,M s de 1 hasta 2 s.m.,25732,18647,7085,0,0,0
2009,Hidalgo,M s de 10 s.m.,610123,270671,339452,0,0,0
2009,Hidalgo,M s de 2 hasta 3 s.m.,319744,314150,5594,0,0,0
2009,Hidalgo,M s de 3 hasta 5 s.m.,587252,327929,259323,0,0,0
2009,Hidalgo,M s de 5 hasta 10 s.m.,80847,68218,12629,0,0,0
2009,Hidalgo,No especificado,20840,13354,7486,0,0,0
2009,Hidalgo,No recibe ingresos,150517,140736,9781,0,0,0
2009,Jalisco,1 salario m¡nimo,18468,17735,733,0,0,0
2009,Jalisco,Menos de 1 s.m.,1156582,1040855,115727,0,0,0
2009,Jalisco,M s de 1 hasta 2 s.m.,56357,39330,17027,0,0,0
2009,Jalisco,M s de 10 s.m.,2350579,1043311,1307268,0,0,0
2009,Jalisco,M s de 2 hasta 3 s.m.,962894,936578,26316,0,0,0
2009,Jalisco,M s de 3 hasta 5 s.m.,2286308,1494612,791696,0,0,0
2009,Jalisco,M s de 5 hasta 10 s.m.,409196,308965,100231,0,0,0
2009,Jalisco,No especificado,92378,58880,33498,0,0,0
2009,Jalisco,No recibe ingresos,404068,360581,43487,0,0,0
2009,Michoac n,1 salario m¡nimo,8827,7078,1749,0,0,0
2009,Michoac n,Menos de 1 s.m.,1376950,1240799,136151,0,0,0
2009,Michoac n,M s de 1 hasta 2 s.m.,18367,14729,3638,0,0,0
2009,Michoac n,M s de 10 s.m.,1445418,569882,875536,0,0,0
2009,Michoac n,M s de 2 hasta 3 s.m.,553122,542381,10741,0,0,0
2009,Michoac n,M s de 3 hasta 5 s.m.,880870,579159,301711,0,0,0
2009,Michoac n,M s de 5 hasta 10 s.m.,141783,122073,19710,0,0,0
2009,Michoac n,No especificado,28642,15383,13259,0,0,0
2009,Michoac n,No recibe ingresos,207718,192628,15090,0,0,0
2009,Morelos,1 salario m¡nimo,10172,10172,0,0,0,0
2009,Morelos,Menos de 1 s.m.,390401,354300,36101,0,0,0
2009,Morelos,M s de 1 hasta 2 s.m.,7453,6423,1030,0,0,0
2009,Morelos,M s de 10 s.m.,585653,226959,358694,0,0,0
2009,Morelos,M s de 2 hasta 3 s.m.,277686,272139,5547,0,0,0
2009,Morelos,M s de 3 hasta 5 s.m.,329566,203302,126264,0,0,0
2009,Morelos,M s de 5 hasta 10 s.m.,53269,41087,12182,0,0,0
2009,Morelos,No especificado,21390,14812,6578,0,0,0
2009,Morelos,No recibe ingresos,109264,101206,8058,0,0,0
2009,Nacional,1 salario m¡nimo,829450,737805,91645,0,0,0
2009,Nacional,Menos de 1 s.m.,24869173,22196276,2672897,0,0,0
2009,Nacional,M s de 1 hasta 2 s.m.,885133,714993,170140,0,0,0
2009,Nacional,M s de 10 s.m.,31633550,14158780,17474770,0,0,0
2009,Nacional,M s de 2 hasta 3 s.m.,14381669,13933311,448358,0,0,0
2009,Nacional,M s de 3 hasta 5 s.m.,27339202,17004105,10335097,0,0,0
2009,Nacional,M s de 5 hasta 10 s.m.,4490253,3390590,1099663,0,0,0
2009,Nacional,No especificado,1509899,958345,551554,0,0,0
2009,Nacional,No recibe ingresos,7824362,7256613,567749,0,0,0
2009,Nayarit,1 salario m¡nimo,2516,2516,0,0,0,0
2009,Nayarit,Menos de 1 s.m.,365668,339031,26637,0,0,0
2009,Nayarit,M s de 1 hasta 2 s.m.,9702,7763,1939,0,0,0
2009,Nayarit,M s de 10 s.m.,345000,118775,226225,0,0,0
2009,Nayarit,M s de 2 hasta 3 s.m.,144349,140225,4124,0,0,0
2009,Nayarit,M s de 3 hasta 5 s.m.,168236,103792,64444,0,0,0
2009,Nayarit,M s de 5 hasta 10 s.m.,36313,27842,8471,0,0,0
2009,Nayarit,No especificado,8984,5776,3208,0,0,0
2009,Nayarit,No recibe ingresos,61459,56217,5242,0,0,0
2009,Nuevo Le¢n,1 salario m¡nimo,9060,7504,1556,0,0,0
2009,Nuevo Le¢n,Menos de 1 s.m.,152973,145241,7732,0,0,0
2009,Nuevo Le¢n,M s de 1 hasta 2 s.m.,43735,36431,7304,0,0,0
2009,Nuevo Le¢n,M s de 10 s.m.,1259653,598387,661266,0,0,0
2009,Nuevo Le¢n,M s de 2 hasta 3 s.m.,721004,684679,36325,0,0,0
2009,Nuevo Le¢n,M s de 3 hasta 5 s.m.,1625783,1172892,452891,0,0,0
2009,Nuevo Le¢n,M s de 5 hasta 10 s.m.,344466,243903,100563,0,0,0
2009,Nuevo Le¢n,No especificado,98950,60257,38693,0,0,0
2009,Nuevo Le¢n,No recibe ingresos,451333,423123,28210,0,0,0
2009,Oaxaca,1 salario m¡nimo,6596,5770,826,0,0,0
2009,Oaxaca,Menos de 1 s.m.,2066880,1766334,300546,0,0,0
2009,Oaxaca,M s de 1 hasta 2 s.m.,11211,9216,1995,0,0,0
2009,Oaxaca,M s de 10 s.m.,916152,305106,611046,0,0,0
2009,Oaxaca,M s de 2 hasta 3 s.m.,465279,458072,7207,0,0,0
2009,Oaxaca,M s de 3 hasta 5 s.m.,770883,259966,510917,0,0,0
2009,Oaxaca,M s de 5 hasta 10 s.m.,67604,48091,19513,0,0,0
2009,Oaxaca,No especificado,17166,11965,5201,0,0,0
2009,Oaxaca,No recibe ingresos,190071,177011,13060,0,0,0
2009,Puebla,1 salario m¡nimo,29467,28680,787,0,0,0
2009,Puebla,Menos de 1 s.m.,2170482,1722613,447869,0,0,0
2009,Puebla,M s de 1 hasta 2 s.m.,29219,24025,5194,0,0,0
2009,Puebla,M s de 10 s.m.,1468593,658061,810532,0,0,0
2009,Puebla,M s de 2 hasta 3 s.m.,660519,646937,13582,0,0,0
2009,Puebla,M s de 3 hasta 5 s.m.,1653604,932328,721276,0,0,0
2009,Puebla,M s de 5 hasta 10 s.m.,200603,138696,61907,0,0,0
2009,Puebla,No especificado,43696,27324,16372,0,0,0
2009,Puebla,No recibe ingresos,291422,276068,15354,0,0,0
2009,Queretaro,1 salario m¡nimo,3472,3472,0,0,0,0
2009,Queretaro,Menos de 1 s.m.,223873,191463,32410,0,0,0
2009,Queretaro,M s de 1 hasta 2 s.m.,13423,12061,1362,0,0,0
2009,Queretaro,M s de 10 s.m.,433798,185893,247905,0,0,0
2009,Queretaro,M s de 2 hasta 3 s.m.,270917,261897,9020,0,0,0
2009,Queretaro,M s de 3 hasta 5 s.m.,543869,353688,190181,0,0,0
2009,Queretaro,M s de 5 hasta 10 s.m.,74297,57816,16481,0,0,0
2009,Queretaro,No especificado,21204,14757,6447,0,0,0
2009,Queretaro,No recibe ingresos,101843,93984,7859,0,0,0
2009,Quintana Roo,1 salario m¡nimo,1302,1193,109,0,0,0
2009,Quintana Roo,Menos de 1 s.m.,129722,119282,10440,0,0,0
2009,Quintana Roo,M s de 1 hasta 2 s.m.,10310,7347,2963,0,0,0
2009,Quintana Roo,M s de 10 s.m.,420086,184690,235396,0,0,0
2009,Quintana Roo,M s de 2 hasta 3 s.m.,232546,222125,10421,0,0,0
2009,Quintana Roo,M s de 3 hasta 5 s.m.,146145,89576,56569,0,0,0
2009,Quintana Roo,M s de 5 hasta 10 s.m.,46158,28915,17243,0,0,0
2009,Quintana Roo,No especificado,25414,15643,9771,0,0,0
2009,Quintana Roo,No recibe ingresos,130659,123143,7516,0,0,0
2009,San Luis Potos¡,1 salario m¡nimo,37250,36865,385,0,0,0
2009,San Luis Potos¡,Menos de 1 s.m.,764446,696939,67507,0,0,0
2009,San Luis Potos¡,M s de 1 hasta 2 s.m.,19937,12706,7231,0,0,0
2009,San Luis Potos¡,M s de 10 s.m.,643541,270132,373409,0,0,0
2009,San Luis Potos¡,M s de 2 hasta 3 s.m.,294674,284777,9897,0,0,0
2009,San Luis Potos¡,M s de 3 hasta 5 s.m.,602675,384550,218125,0,0,0
2009,San Luis Potos¡,M s de 5 hasta 10 s.m.,108684,81298,27386,0,0,0
2009,San Luis Potos¡,No especificado,18909,9971,8938,0,0,0
2009,San Luis Potos¡,No recibe ingresos,139072,130907,8165,0,0,0
2009,Sinaloa,1 salario m¡nimo,15466,14252,1214,0,0,0
2009,Sinaloa,Menos de 1 s.m.,881378,785633,95745,0,0,0
2009,Sinaloa,M s de 1 hasta 2 s.m.,25477,21915,3562,0,0,0
2009,Sinaloa,M s de 10 s.m.,902725,385407,517318,0,0,0
2009,Sinaloa,M s de 2 hasta 3 s.m.,397062,381909,15153,0,0,0
2009,Sinaloa,M s de 3 hasta 5 s.m.,502548,304453,198095,0,0,0
2009,Sinaloa,M s de 5 hasta 10 s.m.,133274,100933,32341,0,0,0
2009,Sinaloa,No especificado,42122,26473,15649,0,0,0
2009,Sinaloa,No recibe ingresos,139417,124179,15238,0,0,0
2009,Sonora,1 salario m¡nimo,44776,40264,4512,0,0,0
2009,Sonora,Menos de 1 s.m.,461027,399478,61549,0,0,0
2009,Sonora,M s de 1 hasta 2 s.m.,21717,17207,4510,0,0,0
2009,Sonora,M s de 10 s.m.,714750,339895,374855,0,0,0
2009,Sonora,M s de 2 hasta 3 s.m.,376928,366356,10572,0,0,0
2009,Sonora,M s de 3 hasta 5 s.m.,780426,429441,350985,0,0,0
2009,Sonora,M s de 5 hasta 10 s.m.,96345,72734,23611,0,0,0
2009,Sonora,No especificado,53858,31349,22509,0,0,0
2009,Sonora,No recibe ingresos,104366,97684,6682,0,0,0
2009,Tabasco,1 salario m¡nimo,149651,127993,21658,0,0,0
2009,Tabasco,Menos de 1 s.m.,612884,583473,29411,0,0,0
2009,Tabasco,M s de 1 hasta 2 s.m.,19452,12027,7425,0,0,0
2009,Tabasco,M s de 10 s.m.,572239,275788,296451,0,0,0
2009,Tabasco,M s de 2 hasta 3 s.m.,260638,253780,6858,0,0,0
2009,Tabasco,M s de 3 hasta 5 s.m.,233150,148232,84918,0,0,0
2009,Tabasco,M s de 5 hasta 10 s.m.,75831,62309,13522,0,0,0
2009,Tabasco,No especificado,17083,10263,6820,0,0,0
2009,Tabasco,No recibe ingresos,146278,137281,8997,0,0,0
2009,Tamaulipas,1 salario m¡nimo,47994,37525,10469,0,0,0
2009,Tamaulipas,Menos de 1 s.m.,346591,328019,18572,0,0,0
2009,Tamaulipas,M s de 1 hasta 2 s.m.,22694,19681,3013,0,0,0
2009,Tamaulipas,M s de 10 s.m.,929830,438008,491822,0,0,0
2009,Tamaulipas,M s de 2 hasta 3 s.m.,507209,482377,24832,0,0,0
2009,Tamaulipas,M s de 3 hasta 5 s.m.,848524,539877,308647,0,0,0
2009,Tamaulipas,M s de 5 hasta 10 s.m.,130563,106195,24368,0,0,0
2009,Tamaulipas,No especificado,52163,29798,22365,0,0,0
2009,Tamaulipas,No recibe ingresos,265083,219639,45444,0,0,0
2009,Tlaxcala,1 salario m¡nimo,2238,1661,577,0,0,0
2009,Tlaxcala,Menos de 1 s.m.,300695,267574,33121,0,0,0
2009,Tlaxcala,M s de 1 hasta 2 s.m.,3642,2694,948,0,0,0
2009,Tlaxcala,M s de 10 s.m.,305076,131533,173543,0,0,0
2009,Tlaxcala,M s de 2 hasta 3 s.m.,166160,163948,2212,0,0,0
2009,Tlaxcala,M s de 3 hasta 5 s.m.,402086,226175,175911,0,0,0
2009,Tlaxcala,M s de 5 hasta 10 s.m.,26282,20282,6000,0,0,0
2009,Tlaxcala,No especificado,4611,2564,2047,0,0,0
2009,Tlaxcala,No recibe ingresos,52459,49984,2475,0,0,0
2009,Veracruz,1 salario m¡nimo,153550,130922,22628,0,0,0
2009,Veracruz,Menos de 1 s.m.,2648562,2521297,127265,0,0,0
2009,Veracruz,M s de 1 hasta 2 s.m.,78243,61349,16894,0,0,0
2009,Veracruz,M s de 10 s.m.,1986088,824302,1161786,0,0,0
2009,Veracruz,M s de 2 hasta 3 s.m.,1036676,1006343,30333,0,0,0
2009,Veracruz,M s de 3 hasta 5 s.m.,1194406,758086,436320,0,0,0
2009,Veracruz,M s de 5 hasta 10 s.m.,181835,139179,42656,0,0,0
2009,Veracruz,No especificado,48994,37274,11720,0,0,0
2009,Veracruz,No recibe ingresos,483771,447509,36262,0,0,0
2009,Yucat n,1 salario m¡nimo,3835,3646,189,0,0,0
2009,Yucat n,Menos de 1 s.m.,412064,382693,29371,0,0,0
2009,Yucat n,M s de 1 hasta 2 s.m.,23220,18076,5144,0,0,0
2009,Yucat n,M s de 10 s.m.,567360,249149,318211,0,0,0
2009,Yucat n,M s de 2 hasta 3 s.m.,307745,301626,6119,0,0,0
2009,Yucat n,M s de 3 hasta 5 s.m.,640424,332981,307443,0,0,0
2009,Yucat n,M s de 5 hasta 10 s.m.,98462,74198,24264,0,0,0
2009,Yucat n,No especificado,31210,20164,11046,0,0,0
2009,Yucat n,No recibe ingresos,130373,122475,7898,0,0,0
2009,Zacatecas,1 salario m¡nimo,17869,16978,891,0,0,0
2009,Zacatecas,Menos de 1 s.m.,601873,523940,77933,0,0,0
2009,Zacatecas,M s de 1 hasta 2 s.m.,4059,3267,792,0,0,0
2009,Zacatecas,M s de 10 s.m.,378401,148607,229794,0,0,0
2009,Zacatecas,M s de 2 hasta 3 s.m.,203082,200197,2885,0,0,0
2009,Zacatecas,M s de 3 hasta 5 s.m.,202693,130657,72036,0,0,0
2009,Zacatecas,M s de 5 hasta 10 s.m.,49447,38520,10927,0,0,0
2009,Zacatecas,No especificado,9344,6445,2899,0,0,0
2009,Zacatecas,No recibe ingresos,30153,28448,1705,0,0,0
2010,Aguascalientes,1 salario m¡nimo,5984,5863,121,0,0,0
2010,Aguascalientes,Menos de 1 s.m.,112163,105827,6336,0,0,0
2010,Aguascalientes,M s de 1 hasta 2 s.m.,6103,4737,1366,0,0,0
2010,Aguascalientes,M s de 10 s.m.,313008,146199,166809,0,0,0
2010,Aguascalientes,M s de 2 hasta 3 s.m.,143229,139491,3738,0,0,0
2010,Aguascalientes,M s de 3 hasta 5 s.m.,384347,260225,124122,0,0,0
2010,Aguascalientes,M s de 5 hasta 10 s.m.,49484,40631,8853,0,0,0
2010,Aguascalientes,No especificado,9731,7092,2639,0,0,0
2010,Aguascalientes,No recibe ingresos,60141,56708,3433,0,0,0
2010,Baja California,1 salario m¡nimo,3991,3849,142,0,0,0
2010,Baja California,Menos de 1 s.m.,347271,266753,80518,0,0,0
2010,Baja California,M s de 1 hasta 2 s.m.,38524,29342,9182,0,0,0
2010,Baja California,M s de 10 s.m.,965560,493942,471618,0,0,0
2010,Baja California,M s de 2 hasta 3 s.m.,381820,372089,9731,0,0,0
2010,Baja California,M s de 3 hasta 5 s.m.,979781,571485,408296,0,0,0
2010,Baja California,M s de 5 hasta 10 s.m.,98296,75448,22848,0,0,0
2010,Baja California,No especificado,35431,22149,13282,0,0,0
2010,Baja California,No recibe ingresos,181301,159166,22135,0,0,0
2010,Baja California Sur,1 salario m¡nimo,9402,8380,1022,0,0,0
2010,Baja California Sur,Menos de 1 s.m.,95969,80172,15797,0,0,0
2010,Baja California Sur,M s de 1 hasta 2 s.m.,18229,15564,2665,0,0,0
2010,Baja California Sur,M s de 10 s.m.,204852,94202,110650,0,0,0
2010,Baja California Sur,M s de 2 hasta 3 s.m.,115828,112609,3219,0,0,0
2010,Baja California Sur,M s de 3 hasta 5 s.m.,83544,54193,29351,0,0,0
2010,Baja California Sur,M s de 5 hasta 10 s.m.,29973,24475,5498,0,0,0
2010,Baja California Sur,No especificado,10600,7392,3208,0,0,0
2010,Baja California Sur,No recibe ingresos,38973,34880,4093,0,0,0
2010,Campeche,1 salario m¡nimo,25993,20360,5633,0,0,0
2010,Campeche,Menos de 1 s.m.,299757,283027,16730,0,0,0
2010,Campeche,M s de 1 hasta 2 s.m.,5667,4859,808,0,0,0
2010,Campeche,M s de 10 s.m.,203684,83542,120142,0,0,0
2010,Campeche,M s de 2 hasta 3 s.m.,124518,121227,3291,0,0,0
2010,Campeche,M s de 3 hasta 5 s.m.,131242,65320,65922,0,0,0
2010,Campeche,M s de 5 hasta 10 s.m.,18440,13931,4509,0,0,0
2010,Campeche,No especificado,7986,5050,2936,0,0,0
2010,Campeche,No recibe ingresos,49019,47576,1443,0,0,0
2010,Chiapas,1 salario m¡nimo,3647,3545,102,0,0,0
2010,Chiapas,Menos de 1 s.m.,2820576,2687908,132668,0,0,0
2010,Chiapas,M s de 1 hasta 2 s.m.,27274,18877,8397,0,0,0
2010,Chiapas,M s de 10 s.m.,998641,364794,633847,0,0,0
2010,Chiapas,M s de 2 hasta 3 s.m.,455485,447502,7983,0,0,0
2010,Chiapas,M s de 3 hasta 5 s.m.,577050,318275,258775,0,0,0
2010,Chiapas,M s de 5 hasta 10 s.m.,123636,89612,34024,0,0,0
2010,Chiapas,No especificado,19745,14209,5536,0,0,0
2010,Chiapas,No recibe ingresos,252995,249332,3663,0,0,0
2010,Chihuahua,1 salario m¡nimo,15983,15445,538,0,0,0
2010,Chihuahua,Menos de 1 s.m.,567172,539581,27591,0,0,0
2010,Chihuahua,M s de 1 hasta 2 s.m.,26028,23965,2063,0,0,0
2010,Chihuahua,M s de 10 s.m.,877721,530381,347340,0,0,0
2010,Chihuahua,M s de 2 hasta 3 s.m.,384495,370204,14291,0,0,0
2010,Chihuahua,M s de 3 hasta 5 s.m.,1089846,667324,422522,0,0,0
2010,Chihuahua,M s de 5 hasta 10 s.m.,89515,71500,18015,0,0,0
2010,Chihuahua,No especificado,58970,42795,16175,0,0,0
2010,Chihuahua,No recibe ingresos,135793,124921,10872,0,0,0
2010,Ciudad de Mxico,1 salario m¡nimo,2321,2321,0,0,0,0
2010,Ciudad de Mxico,Menos de 1 s.m.,55065,49908,5157,0,0,0
2010,Ciudad de Mxico,M s de 1 hasta 2 s.m.,53055,44424,8631,0,0,0
2010,Ciudad de Mxico,M s de 10 s.m.,2875259,1463746,1411513,0,0,0
2010,Ciudad de Mxico,M s de 2 hasta 3 s.m.,845224,782894,62330,0,0,0
2010,Ciudad de Mxico,M s de 3 hasta 5 s.m.,1959149,1246194,712955,0,0,0
2010,Ciudad de Mxico,M s de 5 hasta 10 s.m.,458185,310064,148121,0,0,0
2010,Ciudad de Mxico,No especificado,341800,226698,115102,0,0,0
2010,Ciudad de Mxico,No recibe ingresos,879558,791573,87985,0,0,0
2010,Coahuila,1 salario m¡nimo,58429,56447,1982,0,0,0
2010,Coahuila,Menos de 1 s.m.,235083,219942,15141,0,0,0
2010,Coahuila,M s de 1 hasta 2 s.m.,13556,12053,1503,0,0,0
2010,Coahuila,M s de 10 s.m.,813185,373107,440078,0,0,0
2010,Coahuila,M s de 2 hasta 3 s.m.,318699,309879,8820,0,0,0
2010,Coahuila,M s de 3 hasta 5 s.m.,965169,706648,258521,0,0,0
2010,Coahuila,M s de 5 hasta 10 s.m.,133337,101478,31859,0,0,0
2010,Coahuila,No especificado,41630,29365,12265,0,0,0
2010,Coahuila,No recibe ingresos,155112,147107,8005,0,0,0
2010,Colima,1 salario m¡nimo,11403,10320,1083,0,0,0
2010,Colima,Menos de 1 s.m.,147157,129598,17559,0,0,0
2010,Colima,M s de 1 hasta 2 s.m.,7230,5553,1677,0,0,0
2010,Colima,M s de 10 s.m.,198273,79151,119122,0,0,0
2010,Colima,M s de 2 hasta 3 s.m.,104350,99170,5180,0,0,0
2010,Colima,M s de 3 hasta 5 s.m.,103180,64360,38820,0,0,0
2010,Colima,M s de 5 hasta 10 s.m.,32814,23908,8906,0,0,0
2010,Colima,No especificado,11182,6524,4658,0,0,0
2010,Colima,No recibe ingresos,75014,64589,10425,0,0,0
2010,Durango,1 salario m¡nimo,38976,36574,2402,0,0,0
2010,Durango,Menos de 1 s.m.,428351,416564,11787,0,0,0
2010,Durango,M s de 1 hasta 2 s.m.,13952,10660,3292,0,0,0
2010,Durango,M s de 10 s.m.,362449,145849,216600,0,0,0
2010,Durango,M s de 2 hasta 3 s.m.,189906,184670,5236,0,0,0
2010,Durango,M s de 3 hasta 5 s.m.,355464,254436,101028,0,0,0
2010,Durango,M s de 5 hasta 10 s.m.,48346,34659,13687,0,0,0
2010,Durango,No especificado,17412,9892,7520,0,0,0
2010,Durango,No recibe ingresos,119152,112741,6411,0,0,0
2010,Estado de Mxico,1 salario m¡nimo,25417,25289,128,0,0,0
2010,Estado de Mxico,Menos de 1 s.m.,1281096,1152583,128513,0,0,0
2010,Estado de Mxico,M s de 1 hasta 2 s.m.,71243,58581,12662,0,0,0
2010,Estado de Mxico,M s de 10 s.m.,4635525,2433390,2202135,0,0,0
2010,Estado de Mxico,M s de 2 hasta 3 s.m.,2296994,2218563,78431,0,0,0
2010,Estado de Mxico,M s de 3 hasta 5 s.m.,4372577,2987287,1385290,0,0,0
2010,Estado de Mxico,M s de 5 hasta 10 s.m.,707416,503025,204391,0,0,0
2010,Estado de Mxico,No especificado,203558,128043,75515,0,0,0
2010,Estado de Mxico,No recibe ingresos,1647513,1509836,137677,0,0,0
2010,Guanajuato,1 salario m¡nimo,9627,9333,294,0,0,0
2010,Guanajuato,Menos de 1 s.m.,944095,821537,122558,0,0,0
2010,Guanajuato,M s de 1 hasta 2 s.m.,41925,40153,1772,0,0,0
2010,Guanajuato,M s de 10 s.m.,1600254,700373,899881,0,0,0
2010,Guanajuato,M s de 2 hasta 3 s.m.,625899,607154,18745,0,0,0
2010,Guanajuato,M s de 3 hasta 5 s.m.,2040650,1318190,722460,0,0,0
2010,Guanajuato,M s de 5 hasta 10 s.m.,234015,176514,57501,0,0,0
2010,Guanajuato,No especificado,40572,21198,19374,0,0,0
2010,Guanajuato,No recibe ingresos,182539,164644,17895,0,0,0
2010,Guerrero,1 salario m¡nimo,4126,4032,94,0,0,0
2010,Guerrero,Menos de 1 s.m.,1730007,1396991,333016,0,0,0
2010,Guerrero,M s de 1 hasta 2 s.m.,18687,15747,2940,0,0,0
2010,Guerrero,M s de 10 s.m.,823167,293747,529420,0,0,0
2010,Guerrero,M s de 2 hasta 3 s.m.,320497,310759,9738,0,0,0
2010,Guerrero,M s de 3 hasta 5 s.m.,570022,219533,350489,0,0,0
2010,Guerrero,M s de 5 hasta 10 s.m.,104665,87193,17472,0,0,0
2010,Guerrero,No especificado,23486,14297,9189,0,0,0
2010,Guerrero,No recibe ingresos,198632,192731,5901,0,0,0
2010,Hidalgo,1 salario m¡nimo,14044,12851,1193,0,0,0
2010,Hidalgo,Menos de 1 s.m.,904164,790236,113928,0,0,0
2010,Hidalgo,M s de 1 hasta 2 s.m.,9691,8545,1146,0,0,0
2010,Hidalgo,M s de 10 s.m.,593535,241953,351582,0,0,0
2010,Hidalgo,M s de 2 hasta 3 s.m.,407499,400824,6675,0,0,0
2010,Hidalgo,M s de 3 hasta 5 s.m.,608368,343902,264466,0,0,0
2010,Hidalgo,M s de 5 hasta 10 s.m.,98070,76115,21955,0,0,0
2010,Hidalgo,No especificado,17690,10839,6851,0,0,0
2010,Hidalgo,No recibe ingresos,146739,142127,4612,0,0,0
2010,Jalisco,1 salario m¡nimo,8726,8726,0,0,0,0
2010,Jalisco,Menos de 1 s.m.,1278809,1149934,128875,0,0,0
2010,Jalisco,M s de 1 hasta 2 s.m.,41080,29611,11469,0,0,0
2010,Jalisco,M s de 10 s.m.,2463200,1120227,1342973,0,0,0
2010,Jalisco,M s de 2 hasta 3 s.m.,958016,937410,20606,0,0,0
2010,Jalisco,M s de 3 hasta 5 s.m.,2273522,1489295,784227,0,0,0
2010,Jalisco,M s de 5 hasta 10 s.m.,392915,295802,97113,0,0,0
2010,Jalisco,No especificado,102000,72280,29720,0,0,0
2010,Jalisco,No recibe ingresos,417732,377012,40720,0,0,0
2010,Michoac n,1 salario m¡nimo,4905,4905,0,0,0,0
2010,Michoac n,Menos de 1 s.m.,1459087,1305110,153977,0,0,0
2010,Michoac n,M s de 1 hasta 2 s.m.,20390,18729,1661,0,0,0
2010,Michoac n,M s de 10 s.m.,1262255,529732,732523,0,0,0
2010,Michoac n,M s de 2 hasta 3 s.m.,541215,533895,7320,0,0,0
2010,Michoac n,M s de 3 hasta 5 s.m.,900235,613952,286283,0,0,0
2010,Michoac n,M s de 5 hasta 10 s.m.,141384,116835,24549,0,0,0
2010,Michoac n,No especificado,23554,14974,8580,0,0,0
2010,Michoac n,No recibe ingresos,261230,243467,17763,0,0,0
2010,Morelos,1 salario m¡nimo,10660,10533,127,0,0,0
2010,Morelos,Menos de 1 s.m.,356275,324845,31430,0,0,0
2010,Morelos,M s de 1 hasta 2 s.m.,10202,7289,2913,0,0,0
2010,Morelos,M s de 10 s.m.,570370,246035,324335,0,0,0
2010,Morelos,M s de 2 hasta 3 s.m.,310127,304728,5399,0,0,0
2010,Morelos,M s de 3 hasta 5 s.m.,363387,235072,128315,0,0,0
2010,Morelos,M s de 5 hasta 10 s.m.,56267,42754,13513,0,0,0
2010,Morelos,No especificado,22519,13887,8632,0,0,0
2010,Morelos,No recibe ingresos,131965,124555,7410,0,0,0
2010,Nacional,1 salario m¡nimo,740570,679352,61218,0,0,0
2010,Nacional,Menos de 1 s.m.,25463260,22744944,2718316,0,0,0
2010,Nacional,M s de 1 hasta 2 s.m.,719419,592108,127311,0,0,0
2010,Nacional,M s de 10 s.m.,31953727,14621315,17332412,0,0,0
2010,Nacional,M s de 2 hasta 3 s.m.,14414298,13943878,470420,0,0,0
2010,Nacional,M s de 3 hasta 5 s.m.,28343988,17901927,10442061,0,0,0
2010,Nacional,M s de 5 hasta 10 s.m.,4518729,3395961,1122768,0,0,0
2010,Nacional,No especificado,1458251,940620,517631,0,0,0
2010,Nacional,No recibe ingresos,7573219,7006837,566382,0,0,0
2010,Nayarit,1 salario m¡nimo,1960,1960,0,0,0,0
2010,Nayarit,Menos de 1 s.m.,410819,386675,24144,0,0,0
2010,Nayarit,M s de 1 hasta 2 s.m.,10273,6998,3275,0,0,0
2010,Nayarit,M s de 10 s.m.,365883,141206,224677,0,0,0
2010,Nayarit,M s de 2 hasta 3 s.m.,138722,134806,3916,0,0,0
2010,Nayarit,M s de 3 hasta 5 s.m.,166603,92487,74116,0,0,0
2010,Nayarit,M s de 5 hasta 10 s.m.,46632,38100,8532,0,0,0
2010,Nayarit,No especificado,12252,5922,6330,0,0,0
2010,Nayarit,No recibe ingresos,53756,50876,2880,0,0,0
2010,Nuevo Le¢n,1 salario m¡nimo,8085,8085,0,0,0,0
2010,Nuevo Le¢n,Menos de 1 s.m.,200436,188604,11832,0,0,0
2010,Nuevo Le¢n,M s de 1 hasta 2 s.m.,43901,34034,9867,0,0,0
2010,Nuevo Le¢n,M s de 10 s.m.,1331590,633571,698019,0,0,0
2010,Nuevo Le¢n,M s de 2 hasta 3 s.m.,741383,704630,36753,0,0,0
2010,Nuevo Le¢n,M s de 3 hasta 5 s.m.,1695801,1218939,476862,0,0,0
2010,Nuevo Le¢n,M s de 5 hasta 10 s.m.,283326,218672,64654,0,0,0
2010,Nuevo Le¢n,No especificado,98996,55678,43318,0,0,0
2010,Nuevo Le¢n,No recibe ingresos,433940,404701,29239,0,0,0
2010,Oaxaca,1 salario m¡nimo,5744,5438,306,0,0,0
2010,Oaxaca,Menos de 1 s.m.,2021599,1727184,294415,0,0,0
2010,Oaxaca,M s de 1 hasta 2 s.m.,9692,7140,2552,0,0,0
2010,Oaxaca,M s de 10 s.m.,914624,323409,591215,0,0,0
2010,Oaxaca,M s de 2 hasta 3 s.m.,427246,418105,9141,0,0,0
2010,Oaxaca,M s de 3 hasta 5 s.m.,794597,309447,485150,0,0,0
2010,Oaxaca,M s de 5 hasta 10 s.m.,71669,55057,16612,0,0,0
2010,Oaxaca,No especificado,17779,12971,4808,0,0,0
2010,Oaxaca,No recibe ingresos,190091,180581,9510,0,0,0
2010,Puebla,1 salario m¡nimo,49218,48401,817,0,0,0
2010,Puebla,Menos de 1 s.m.,2154349,1690425,463924,0,0,0
2010,Puebla,M s de 1 hasta 2 s.m.,20439,18414,2025,0,0,0
2010,Puebla,M s de 10 s.m.,1645307,709583,935724,0,0,0
2010,Puebla,M s de 2 hasta 3 s.m.,685864,674737,11127,0,0,0
2010,Puebla,M s de 3 hasta 5 s.m.,1591291,926394,664897,0,0,0
2010,Puebla,M s de 5 hasta 10 s.m.,188688,141117,47571,0,0,0
2010,Puebla,No especificado,45947,29289,16658,0,0,0
2010,Puebla,No recibe ingresos,292804,279319,13485,0,0,0
2010,Queretaro,1 salario m¡nimo,3350,3350,0,0,0,0
2010,Queretaro,Menos de 1 s.m.,203798,186088,17710,0,0,0
2010,Queretaro,M s de 1 hasta 2 s.m.,11113,9390,1723,0,0,0
2010,Queretaro,M s de 10 s.m.,430494,199069,231425,0,0,0
2010,Queretaro,M s de 2 hasta 3 s.m.,286321,277826,8495,0,0,0
2010,Queretaro,M s de 3 hasta 5 s.m.,593554,386903,206651,0,0,0
2010,Queretaro,M s de 5 hasta 10 s.m.,83681,65214,18467,0,0,0
2010,Queretaro,No especificado,30193,18443,11750,0,0,0
2010,Queretaro,No recibe ingresos,104039,98587,5452,0,0,0
2010,Quintana Roo,1 salario m¡nimo,1970,1970,0,0,0,0
2010,Quintana Roo,Menos de 1 s.m.,165658,154521,11137,0,0,0
2010,Quintana Roo,M s de 1 hasta 2 s.m.,13732,11045,2687,0,0,0
2010,Quintana Roo,M s de 10 s.m.,446823,198316,248507,0,0,0
2010,Quintana Roo,M s de 2 hasta 3 s.m.,199694,190371,9323,0,0,0
2010,Quintana Roo,M s de 3 hasta 5 s.m.,148215,85147,63068,0,0,0
2010,Quintana Roo,M s de 5 hasta 10 s.m.,49250,32913,16337,0,0,0
2010,Quintana Roo,No especificado,22282,12894,9388,0,0,0
2010,Quintana Roo,No recibe ingresos,144317,135565,8752,0,0,0
2010,San Luis Potos¡,1 salario m¡nimo,29174,27277,1897,0,0,0
2010,San Luis Potos¡,Menos de 1 s.m.,839868,768411,71457,0,0,0
2010,San Luis Potos¡,M s de 1 hasta 2 s.m.,12009,10500,1509,0,0,0
2010,San Luis Potos¡,M s de 10 s.m.,635095,292182,342913,0,0,0
2010,San Luis Potos¡,M s de 2 hasta 3 s.m.,248982,240588,8394,0,0,0
2010,San Luis Potos¡,M s de 3 hasta 5 s.m.,645444,412716,232728,0,0,0
2010,San Luis Potos¡,M s de 5 hasta 10 s.m.,104792,83430,21362,0,0,0
2010,San Luis Potos¡,No especificado,23217,12539,10678,0,0,0
2010,San Luis Potos¡,No recibe ingresos,126262,116856,9406,0,0,0
2010,Sinaloa,1 salario m¡nimo,10589,10589,0,0,0,0
2010,Sinaloa,Menos de 1 s.m.,927581,804270,123311,0,0,0
2010,Sinaloa,M s de 1 hasta 2 s.m.,24397,22884,1513,0,0,0
2010,Sinaloa,M s de 10 s.m.,916063,415343,500720,0,0,0
2010,Sinaloa,M s de 2 hasta 3 s.m.,372546,354202,18344,0,0,0
2010,Sinaloa,M s de 3 hasta 5 s.m.,457968,269258,188710,0,0,0
2010,Sinaloa,M s de 5 hasta 10 s.m.,193190,137675,55515,0,0,0
2010,Sinaloa,No especificado,29263,21732,7531,0,0,0
2010,Sinaloa,No recibe ingresos,131770,116788,14982,0,0,0
2010,Sonora,1 salario m¡nimo,35226,32555,2671,0,0,0
2010,Sonora,Menos de 1 s.m.,467603,416910,50693,0,0,0
2010,Sonora,M s de 1 hasta 2 s.m.,21179,16334,4845,0,0,0
2010,Sonora,M s de 10 s.m.,764728,349496,415232,0,0,0
2010,Sonora,M s de 2 hasta 3 s.m.,358832,345487,13345,0,0,0
2010,Sonora,M s de 3 hasta 5 s.m.,766137,430580,335557,0,0,0
2010,Sonora,M s de 5 hasta 10 s.m.,99008,73178,25830,0,0,0
2010,Sonora,No especificado,35594,21713,13881,0,0,0
2010,Sonora,No recibe ingresos,126227,113890,12337,0,0,0
2010,Tabasco,1 salario m¡nimo,174918,157577,17341,0,0,0
2010,Tabasco,Menos de 1 s.m.,596611,574575,22036,0,0,0
2010,Tabasco,M s de 1 hasta 2 s.m.,14506,11494,3012,0,0,0
2010,Tabasco,M s de 10 s.m.,563494,248958,314536,0,0,0
2010,Tabasco,M s de 2 hasta 3 s.m.,275912,268895,7017,0,0,0
2010,Tabasco,M s de 3 hasta 5 s.m.,239190,164509,74681,0,0,0
2010,Tabasco,M s de 5 hasta 10 s.m.,77541,64886,12655,0,0,0
2010,Tabasco,No especificado,17612,10543,7069,0,0,0
2010,Tabasco,No recibe ingresos,135624,131153,4471,0,0,0
2010,Tamaulipas,1 salario m¡nimo,49402,37051,12351,0,0,0
2010,Tamaulipas,Menos de 1 s.m.,372687,348110,24577,0,0,0
2010,Tamaulipas,M s de 1 hasta 2 s.m.,25804,22005,3799,0,0,0
2010,Tamaulipas,M s de 10 s.m.,963526,441355,522171,0,0,0
2010,Tamaulipas,M s de 2 hasta 3 s.m.,523643,505693,17950,0,0,0
2010,Tamaulipas,M s de 3 hasta 5 s.m.,987275,649199,338076,0,0,0
2010,Tamaulipas,M s de 5 hasta 10 s.m.,124000,95856,28144,0,0,0
2010,Tamaulipas,No especificado,44955,25576,19379,0,0,0
2010,Tamaulipas,No recibe ingresos,254067,231437,22630,0,0,0
2010,Tlaxcala,1 salario m¡nimo,1069,963,106,0,0,0
2010,Tlaxcala,Menos de 1 s.m.,277935,248605,29330,0,0,0
2010,Tlaxcala,M s de 1 hasta 2 s.m.,2733,2210,523,0,0,0
2010,Tlaxcala,M s de 10 s.m.,288491,130418,158073,0,0,0
2010,Tlaxcala,M s de 2 hasta 3 s.m.,159242,155657,3585,0,0,0
2010,Tlaxcala,M s de 3 hasta 5 s.m.,417545,233416,184129,0,0,0
2010,Tlaxcala,M s de 5 hasta 10 s.m.,24512,18483,6029,0,0,0
2010,Tlaxcala,No especificado,7495,4432,3063,0,0,0
2010,Tlaxcala,No recibe ingresos,62640,60374,2266,0,0,0
2010,Veracruz,1 salario m¡nimo,93630,84044,9586,0,0,0
2010,Veracruz,Menos de 1 s.m.,2777403,2625908,151495,0,0,0
2010,Veracruz,M s de 1 hasta 2 s.m.,67713,56005,11708,0,0,0
2010,Veracruz,M s de 10 s.m.,1997997,804252,1193745,0,0,0
2010,Veracruz,M s de 2 hasta 3 s.m.,980498,937571,42927,0,0,0
2010,Veracruz,M s de 3 hasta 5 s.m.,1178684,791997,386687,0,0,0
2010,Veracruz,M s de 5 hasta 10 s.m.,210944,175593,35351,0,0,0
2010,Veracruz,No especificado,49240,34628,14612,0,0,0
2010,Veracruz,No recibe ingresos,408409,380442,27967,0,0,0
2010,Yucat n,1 salario m¡nimo,3655,3655,0,0,0,0
2010,Yucat n,Menos de 1 s.m.,393107,371111,21996,0,0,0
2010,Yucat n,M s de 1 hasta 2 s.m.,14196,11435,2761,0,0,0
2010,Yucat n,M s de 10 s.m.,537851,235345,302506,0,0,0
2010,Yucat n,M s de 2 hasta 3 s.m.,298952,292662,6290,0,0,0
2010,Yucat n,M s de 3 hasta 5 s.m.,667755,362929,304826,0,0,0
2010,Yucat n,M s de 5 hasta 10 s.m.,98988,74116,24872,0,0,0
2010,Yucat n,No especificado,26701,20487,6214,0,0,0
2010,Yucat n,No recibe ingresos,141581,132625,8956,0,0,0
2010,Zacatecas,1 salario m¡nimo,18946,17664,1282,0,0,0
2010,Zacatecas,Menos de 1 s.m.,591709,533031,58678,0,0,0
2010,Zacatecas,M s de 1 hasta 2 s.m.,4896,3531,1365,0,0,0
2010,Zacatecas,M s de 10 s.m.,390823,158442,232381,0,0,0
2010,Zacatecas,M s de 2 hasta 3 s.m.,192660,189580,3080,0,0,0
2010,Zacatecas,M s de 3 hasta 5 s.m.,236396,152315,84081,0,0,0
2010,Zacatecas,M s de 5 hasta 10 s.m.,45750,37727,8023,0,0,0
2010,Zacatecas,No especificado,8859,7089,1770,0,0,0
2010,Zacatecas,No recibe ingresos,34284,30678,3606,0,0,0
2011,Aguascalientes,1 salario m¡nimo,4849,4298,551,0,0,0
2011,Aguascalientes,Menos de 1 s.m.,121722,113079,8643,0,0,0
2011,Aguascalientes,M s de 1 hasta 2 s.m.,7783,6917,866,0,0,0
2011,Aguascalientes,M s de 10 s.m.,332554,161317,171237,0,0,0
2011,Aguascalientes,M s de 2 hasta 3 s.m.,145256,140652,4604,0,0,0
2011,Aguascalientes,M s de 3 hasta 5 s.m.,378058,258909,119149,0,0,0
2011,Aguascalientes,M s de 5 hasta 10 s.m.,47764,40165,7599,0,0,0
2011,Aguascalientes,No especificado,9627,7225,2402,0,0,0
2011,Aguascalientes,No recibe ingresos,57027,53694,3333,0,0,0
2011,Baja California,1 salario m¡nimo,5287,4901,386,0,0,0
2011,Baja California,Menos de 1 s.m.,344188,268643,75545,0,0,0
2011,Baja California,M s de 1 hasta 2 s.m.,46487,35840,10647,0,0,0
2011,Baja California,M s de 10 s.m.,966336,501876,464460,0,0,0
2011,Baja California,M s de 2 hasta 3 s.m.,384995,369151,15844,0,0,0
2011,Baja California,M s de 3 hasta 5 s.m.,1019167,605129,414038,0,0,0
2011,Baja California,M s de 5 hasta 10 s.m.,115051,86814,28237,0,0,0
2011,Baja California,No especificado,38739,25034,13705,0,0,0
2011,Baja California,No recibe ingresos,174870,152077,22793,0,0,0
2011,Baja California Sur,1 salario m¡nimo,11553,9883,1670,0,0,0
2011,Baja California Sur,Menos de 1 s.m.,108250,88045,20205,0,0,0
2011,Baja California Sur,M s de 1 hasta 2 s.m.,18765,13838,4927,0,0,0
2011,Baja California Sur,M s de 10 s.m.,203528,93308,110220,0,0,0
2011,Baja California Sur,M s de 2 hasta 3 s.m.,99471,95784,3687,0,0,0
2011,Baja California Sur,M s de 3 hasta 5 s.m.,93534,62587,30947,0,0,0
2011,Baja California Sur,M s de 5 hasta 10 s.m.,34765,24697,10068,0,0,0
2011,Baja California Sur,No especificado,12175,8132,4043,0,0,0
2011,Baja California Sur,No recibe ingresos,36947,33415,3532,0,0,0
2011,Campeche,1 salario m¡nimo,28859,22713,6146,0,0,0
2011,Campeche,Menos de 1 s.m.,299988,280485,19503,0,0,0
2011,Campeche,M s de 1 hasta 2 s.m.,6805,5523,1282,0,0,0
2011,Campeche,M s de 10 s.m.,224984,90233,134751,0,0,0
2011,Campeche,M s de 2 hasta 3 s.m.,126491,122983,3508,0,0,0
2011,Campeche,M s de 3 hasta 5 s.m.,130908,65597,65311,0,0,0
2011,Campeche,M s de 5 hasta 10 s.m.,17793,13556,4237,0,0,0
2011,Campeche,No especificado,10635,7126,3509,0,0,0
2011,Campeche,No recibe ingresos,48723,47151,1572,0,0,0
2011,Chiapas,1 salario m¡nimo,5514,5441,73,0,0,0
2011,Chiapas,Menos de 1 s.m.,2982940,2796589,186351,0,0,0
2011,Chiapas,M s de 1 hasta 2 s.m.,28804,20071,8733,0,0,0
2011,Chiapas,M s de 10 s.m.,1010995,359714,651281,0,0,0
2011,Chiapas,M s de 2 hasta 3 s.m.,446895,437424,9471,0,0,0
2011,Chiapas,M s de 3 hasta 5 s.m.,536931,285265,251666,0,0,0
2011,Chiapas,M s de 5 hasta 10 s.m.,134541,101376,33165,0,0,0
2011,Chiapas,No especificado,20990,15984,5006,0,0,0
2011,Chiapas,No recibe ingresos,225582,218628,6954,0,0,0
2011,Chihuahua,1 salario m¡nimo,18214,17418,796,0,0,0
2011,Chihuahua,Menos de 1 s.m.,540272,509046,31226,0,0,0
2011,Chihuahua,M s de 1 hasta 2 s.m.,31856,26608,5248,0,0,0
2011,Chihuahua,M s de 10 s.m.,831280,506304,324976,0,0,0
2011,Chihuahua,M s de 2 hasta 3 s.m.,377208,364172,13036,0,0,0
2011,Chihuahua,M s de 3 hasta 5 s.m.,1140305,720963,419342,0,0,0
2011,Chihuahua,M s de 5 hasta 10 s.m.,92135,77772,14363,0,0,0
2011,Chihuahua,No especificado,62377,43878,18499,0,0,0
2011,Chihuahua,No recibe ingresos,115355,104241,11114,0,0,0
2011,Ciudad de Mxico,1 salario m¡nimo,13137,11559,1578,0,0,0
2011,Ciudad de Mxico,Menos de 1 s.m.,56972,46798,10174,0,0,0
2011,Ciudad de Mxico,M s de 1 hasta 2 s.m.,33145,24832,8313,0,0,0
2011,Ciudad de Mxico,M s de 10 s.m.,2901446,1420335,1481111,0,0,0
2011,Ciudad de Mxico,M s de 2 hasta 3 s.m.,819498,756260,63238,0,0,0
2011,Ciudad de Mxico,M s de 3 hasta 5 s.m.,1782365,1119392,662973,0,0,0
2011,Ciudad de Mxico,M s de 5 hasta 10 s.m.,466969,339022,127947,0,0,0
2011,Ciudad de Mxico,No especificado,334141,219783,114358,0,0,0
2011,Ciudad de Mxico,No recibe ingresos,933348,833094,100254,0,0,0
2011,Coahuila,1 salario m¡nimo,67769,65315,2454,0,0,0
2011,Coahuila,Menos de 1 s.m.,260524,240456,20068,0,0,0
2011,Coahuila,M s de 1 hasta 2 s.m.,17553,13723,3830,0,0,0
2011,Coahuila,M s de 10 s.m.,788392,359517,428875,0,0,0
2011,Coahuila,M s de 2 hasta 3 s.m.,369682,355489,14193,0,0,0
2011,Coahuila,M s de 3 hasta 5 s.m.,1073424,760163,313261,0,0,0
2011,Coahuila,M s de 5 hasta 10 s.m.,136186,106726,29460,0,0,0
2011,Coahuila,No especificado,38603,30597,8006,0,0,0
2011,Coahuila,No recibe ingresos,184131,174628,9503,0,0,0
2011,Colima,1 salario m¡nimo,13159,12351,808,0,0,0
2011,Colima,Menos de 1 s.m.,152894,132965,19929,0,0,0
2011,Colima,M s de 1 hasta 2 s.m.,7454,5807,1647,0,0,0
2011,Colima,M s de 10 s.m.,202655,78427,124228,0,0,0
2011,Colima,M s de 2 hasta 3 s.m.,113690,107331,6359,0,0,0
2011,Colima,M s de 3 hasta 5 s.m.,95874,56411,39463,0,0,0
2011,Colima,M s de 5 hasta 10 s.m.,32080,23570,8510,0,0,0
2011,Colima,No especificado,10049,7337,2712,0,0,0
2011,Colima,No recibe ingresos,68022,59735,8287,0,0,0
2011,Durango,1 salario m¡nimo,40787,37968,2819,0,0,0
2011,Durango,Menos de 1 s.m.,367514,360393,7121,0,0,0
2011,Durango,M s de 1 hasta 2 s.m.,20565,19465,1100,0,0,0
2011,Durango,M s de 10 s.m.,389361,152671,236690,0,0,0
2011,Durango,M s de 2 hasta 3 s.m.,205357,200150,5207,0,0,0
2011,Durango,M s de 3 hasta 5 s.m.,376179,256219,119960,0,0,0
2011,Durango,M s de 5 hasta 10 s.m.,57129,42908,14221,0,0,0
2011,Durango,No especificado,13213,8534,4679,0,0,0
2011,Durango,No recibe ingresos,116125,111736,4389,0,0,0
2011,Estado de Mxico,1 salario m¡nimo,21335,19788,1547,0,0,0
2011,Estado de Mxico,Menos de 1 s.m.,1224433,1098597,125836,0,0,0
2011,Estado de Mxico,M s de 1 hasta 2 s.m.,67001,54232,12769,0,0,0
2011,Estado de Mxico,M s de 10 s.m.,4863142,2463324,2399818,0,0,0
2011,Estado de Mxico,M s de 2 hasta 3 s.m.,2327621,2251637,75984,0,0,0
2011,Estado de Mxico,M s de 3 hasta 5 s.m.,4521048,3122217,1398831,0,0,0
2011,Estado de Mxico,M s de 5 hasta 10 s.m.,638528,483415,155113,0,0,0
2011,Estado de Mxico,No especificado,284542,192762,91780,0,0,0
2011,Estado de Mxico,No recibe ingresos,1642541,1528847,113694,0,0,0
2011,Guanajuato,1 salario m¡nimo,7827,7031,796,0,0,0
2011,Guanajuato,Menos de 1 s.m.,897740,804966,92774,0,0,0
2011,Guanajuato,M s de 1 hasta 2 s.m.,34664,28842,5822,0,0,0
2011,Guanajuato,M s de 10 s.m.,1656836,672070,984766,0,0,0
2011,Guanajuato,M s de 2 hasta 3 s.m.,663624,642172,21452,0,0,0
2011,Guanajuato,M s de 3 hasta 5 s.m.,2130058,1414049,716009,0,0,0
2011,Guanajuato,M s de 5 hasta 10 s.m.,258380,195184,63196,0,0,0
2011,Guanajuato,No especificado,43339,25538,17801,0,0,0
2011,Guanajuato,No recibe ingresos,178645,166961,11684,0,0,0
2011,Guerrero,1 salario m¡nimo,2234,2046,188,0,0,0
2011,Guerrero,Menos de 1 s.m.,1755567,1429191,326376,0,0,0
2011,Guerrero,M s de 1 hasta 2 s.m.,14115,10717,3398,0,0,0
2011,Guerrero,M s de 10 s.m.,882346,311925,570421,0,0,0
2011,Guerrero,M s de 2 hasta 3 s.m.,329768,324619,5149,0,0,0
2011,Guerrero,M s de 3 hasta 5 s.m.,526855,199559,327296,0,0,0
2011,Guerrero,M s de 5 hasta 10 s.m.,81336,58401,22935,0,0,0
2011,Guerrero,No especificado,19657,13008,6649,0,0,0
2011,Guerrero,No recibe ingresos,210937,202971,7966,0,0,0
2011,Hidalgo,1 salario m¡nimo,19199,19092,107,0,0,0
2011,Hidalgo,Menos de 1 s.m.,878873,764898,113975,0,0,0
2011,Hidalgo,M s de 1 hasta 2 s.m.,9579,8896,683,0,0,0
2011,Hidalgo,M s de 10 s.m.,684323,296871,387452,0,0,0
2011,Hidalgo,M s de 2 hasta 3 s.m.,391297,382996,8301,0,0,0
2011,Hidalgo,M s de 3 hasta 5 s.m.,652541,404052,248489,0,0,0
2011,Hidalgo,M s de 5 hasta 10 s.m.,83447,69804,13643,0,0,0
2011,Hidalgo,No especificado,14336,8957,5379,0,0,0
2011,Hidalgo,No recibe ingresos,146964,141306,5658,0,0,0
2011,Jalisco,1 salario m¡nimo,14417,14080,337,0,0,0
2011,Jalisco,Menos de 1 s.m.,1237173,1107779,129394,0,0,0
2011,Jalisco,M s de 1 hasta 2 s.m.,23162,18394,4768,0,0,0
2011,Jalisco,M s de 10 s.m.,2649423,1149459,1499964,0,0,0
2011,Jalisco,M s de 2 hasta 3 s.m.,965441,933323,32118,0,0,0
2011,Jalisco,M s de 3 hasta 5 s.m.,2301650,1467829,833821,0,0,0
2011,Jalisco,M s de 5 hasta 10 s.m.,351265,256987,94278,0,0,0
2011,Jalisco,No especificado,88746,55630,33116,0,0,0
2011,Jalisco,No recibe ingresos,416299,387053,29246,0,0,0
2011,Michoac n,1 salario m¡nimo,4135,4135,0,0,0,0
2011,Michoac n,Menos de 1 s.m.,1638320,1474499,163821,0,0,0
2011,Michoac n,M s de 1 hasta 2 s.m.,30781,28989,1792,0,0,0
2011,Michoac n,M s de 10 s.m.,1152441,495532,656909,0,0,0
2011,Michoac n,M s de 2 hasta 3 s.m.,654113,636110,18003,0,0,0
2011,Michoac n,M s de 3 hasta 5 s.m.,918005,613858,304147,0,0,0
2011,Michoac n,M s de 5 hasta 10 s.m.,155601,130840,24761,0,0,0
2011,Michoac n,No especificado,30434,12248,18186,0,0,0
2011,Michoac n,No recibe ingresos,239505,225899,13606,0,0,0
2011,Morelos,1 salario m¡nimo,9118,8771,347,0,0,0
2011,Morelos,Menos de 1 s.m.,355535,328984,26551,0,0,0
2011,Morelos,M s de 1 hasta 2 s.m.,10474,7579,2895,0,0,0
2011,Morelos,M s de 10 s.m.,565780,237896,327884,0,0,0
2011,Morelos,M s de 2 hasta 3 s.m.,301663,294629,7034,0,0,0
2011,Morelos,M s de 3 hasta 5 s.m.,346686,216630,130056,0,0,0
2011,Morelos,M s de 5 hasta 10 s.m.,52787,38356,14431,0,0,0
2011,Morelos,No especificado,22132,14347,7785,0,0,0
2011,Morelos,No recibe ingresos,132192,126128,6064,0,0,0
2011,Nacional,1 salario m¡nimo,730391,671513,58878,0,0,0
2011,Nacional,Menos de 1 s.m.,25577933,22767405,2810528,0,0,0
2011,Nacional,M s de 1 hasta 2 s.m.,715170,577210,137960,0,0,0
2011,Nacional,M s de 10 s.m.,32717080,14729728,17987352,0,0,0
2011,Nacional,M s de 2 hasta 3 s.m.,14653792,14154138,499654,0,0,0
2011,Nacional,M s de 3 hasta 5 s.m.,28848643,18290527,10558116,0,0,0
2011,Nacional,M s de 5 hasta 10 s.m.,4454207,3390214,1063993,0,0,0
2011,Nacional,No especificado,1548810,995101,553709,0,0,0
2011,Nacional,No recibe ingresos,7565854,7018250,547604,0,0,0
2011,Nayarit,1 salario m¡nimo,3300,3300,0,0,0,0
2011,Nayarit,Menos de 1 s.m.,386365,366955,19410,0,0,0
2011,Nayarit,M s de 1 hasta 2 s.m.,9781,7655,2126,0,0,0
2011,Nayarit,M s de 10 s.m.,348153,136253,211900,0,0,0
2011,Nayarit,M s de 2 hasta 3 s.m.,143350,139753,3597,0,0,0
2011,Nayarit,M s de 3 hasta 5 s.m.,178050,107715,70335,0,0,0
2011,Nayarit,M s de 5 hasta 10 s.m.,37623,29357,8266,0,0,0
2011,Nayarit,No especificado,12618,6730,5888,0,0,0
2011,Nayarit,No recibe ingresos,52774,49464,3310,0,0,0
2011,Nuevo Le¢n,1 salario m¡nimo,4210,4210,0,0,0,0
2011,Nuevo Le¢n,Menos de 1 s.m.,184800,169241,15559,0,0,0
2011,Nuevo Le¢n,M s de 1 hasta 2 s.m.,35277,22582,12695,0,0,0
2011,Nuevo Le¢n,M s de 10 s.m.,1269589,628595,640994,0,0,0
2011,Nuevo Le¢n,M s de 2 hasta 3 s.m.,754190,709167,45023,0,0,0
2011,Nuevo Le¢n,M s de 3 hasta 5 s.m.,1814343,1293726,520617,0,0,0
2011,Nuevo Le¢n,M s de 5 hasta 10 s.m.,279756,211146,68610,0,0,0
2011,Nuevo Le¢n,No especificado,76378,41861,34517,0,0,0
2011,Nuevo Le¢n,No recibe ingresos,467451,424301,43150,0,0,0
2011,Oaxaca,1 salario m¡nimo,5007,4688,319,0,0,0
2011,Oaxaca,Menos de 1 s.m.,2134871,1785918,348953,0,0,0
2011,Oaxaca,M s de 1 hasta 2 s.m.,7666,4943,2723,0,0,0
2011,Oaxaca,M s de 10 s.m.,938251,316222,622029,0,0,0
2011,Oaxaca,M s de 2 hasta 3 s.m.,393381,387625,5756,0,0,0
2011,Oaxaca,M s de 3 hasta 5 s.m.,775885,308936,466949,0,0,0
2011,Oaxaca,M s de 5 hasta 10 s.m.,65884,53072,12812,0,0,0
2011,Oaxaca,No especificado,19372,12590,6782,0,0,0
2011,Oaxaca,No recibe ingresos,200966,194855,6111,0,0,0
2011,Puebla,1 salario m¡nimo,18542,17245,1297,0,0,0
2011,Puebla,Menos de 1 s.m.,2201724,1716790,484934,0,0,0
2011,Puebla,M s de 1 hasta 2 s.m.,19972,16583,3389,0,0,0
2011,Puebla,M s de 10 s.m.,1678292,692591,985701,0,0,0
2011,Puebla,M s de 2 hasta 3 s.m.,726904,712810,14094,0,0,0
2011,Puebla,M s de 3 hasta 5 s.m.,1589073,936923,652150,0,0,0
2011,Puebla,M s de 5 hasta 10 s.m.,203602,152925,50677,0,0,0
2011,Puebla,No especificado,41816,27669,14147,0,0,0
2011,Puebla,No recibe ingresos,248475,238181,10294,0,0,0
2011,Queretaro,1 salario m¡nimo,4389,4389,0,0,0,0
2011,Queretaro,Menos de 1 s.m.,189880,169085,20795,0,0,0
2011,Queretaro,M s de 1 hasta 2 s.m.,13103,10684,2419,0,0,0
2011,Queretaro,M s de 10 s.m.,437389,192213,245176,0,0,0
2011,Queretaro,M s de 2 hasta 3 s.m.,308020,297483,10537,0,0,0
2011,Queretaro,M s de 3 hasta 5 s.m.,626196,409332,216864,0,0,0
2011,Queretaro,M s de 5 hasta 10 s.m.,87781,66154,21627,0,0,0
2011,Queretaro,No especificado,26657,15357,11300,0,0,0
2011,Queretaro,No recibe ingresos,111861,102593,9268,0,0,0
2011,Quintana Roo,1 salario m¡nimo,2972,2972,0,0,0,0
2011,Quintana Roo,Menos de 1 s.m.,170607,161607,9000,0,0,0
2011,Quintana Roo,M s de 1 hasta 2 s.m.,12808,11239,1569,0,0,0
2011,Quintana Roo,M s de 10 s.m.,467797,207035,260762,0,0,0
2011,Quintana Roo,M s de 2 hasta 3 s.m.,200610,193819,6791,0,0,0
2011,Quintana Roo,M s de 3 hasta 5 s.m.,149934,93312,56622,0,0,0
2011,Quintana Roo,M s de 5 hasta 10 s.m.,52534,39115,13419,0,0,0
2011,Quintana Roo,No especificado,24426,16015,8411,0,0,0
2011,Quintana Roo,No recibe ingresos,132236,123770,8466,0,0,0
2011,San Luis Potos¡,1 salario m¡nimo,24659,22609,2050,0,0,0
2011,San Luis Potos¡,Menos de 1 s.m.,748690,691718,56972,0,0,0
2011,San Luis Potos¡,M s de 1 hasta 2 s.m.,12140,10757,1383,0,0,0
2011,San Luis Potos¡,M s de 10 s.m.,634573,267202,367371,0,0,0
2011,San Luis Potos¡,M s de 2 hasta 3 s.m.,256622,246584,10038,0,0,0
2011,San Luis Potos¡,M s de 3 hasta 5 s.m.,653579,426506,227073,0,0,0
2011,San Luis Potos¡,M s de 5 hasta 10 s.m.,92172,73926,18246,0,0,0
2011,San Luis Potos¡,No especificado,22742,15251,7491,0,0,0
2011,San Luis Potos¡,No recibe ingresos,111263,101759,9504,0,0,0
2011,Sinaloa,1 salario m¡nimo,10510,10510,0,0,0,0
2011,Sinaloa,Menos de 1 s.m.,856489,748955,107534,0,0,0
2011,Sinaloa,M s de 1 hasta 2 s.m.,18302,16482,1820,0,0,0
2011,Sinaloa,M s de 10 s.m.,976187,440758,535429,0,0,0
2011,Sinaloa,M s de 2 hasta 3 s.m.,340432,327110,13322,0,0,0
2011,Sinaloa,M s de 3 hasta 5 s.m.,458093,269469,188624,0,0,0
2011,Sinaloa,M s de 5 hasta 10 s.m.,146391,107486,38905,0,0,0
2011,Sinaloa,No especificado,34006,21633,12373,0,0,0
2011,Sinaloa,No recibe ingresos,118206,108353,9853,0,0,0
2011,Sonora,1 salario m¡nimo,46704,44408,2296,0,0,0
2011,Sonora,Menos de 1 s.m.,500413,435344,65069,0,0,0
2011,Sonora,M s de 1 hasta 2 s.m.,47504,37824,9680,0,0,0
2011,Sonora,M s de 10 s.m.,798395,362239,436156,0,0,0
2011,Sonora,M s de 2 hasta 3 s.m.,387140,372139,15001,0,0,0
2011,Sonora,M s de 3 hasta 5 s.m.,839554,470671,368883,0,0,0
2011,Sonora,M s de 5 hasta 10 s.m.,103926,71182,32744,0,0,0
2011,Sonora,No especificado,42150,25173,16977,0,0,0
2011,Sonora,No recibe ingresos,108097,97380,10717,0,0,0
2011,Tabasco,1 salario m¡nimo,155385,134553,20832,0,0,0
2011,Tabasco,Menos de 1 s.m.,579691,553861,25830,0,0,0
2011,Tabasco,M s de 1 hasta 2 s.m.,18396,15920,2476,0,0,0
2011,Tabasco,M s de 10 s.m.,641685,283984,357701,0,0,0
2011,Tabasco,M s de 2 hasta 3 s.m.,284876,278151,6725,0,0,0
2011,Tabasco,M s de 3 hasta 5 s.m.,241297,160006,81291,0,0,0
2011,Tabasco,M s de 5 hasta 10 s.m.,75403,59175,16228,0,0,0
2011,Tabasco,No especificado,23827,16057,7770,0,0,0
2011,Tabasco,No recibe ingresos,133842,130423,3419,0,0,0
2011,Tamaulipas,1 salario m¡nimo,38773,34827,3946,0,0,0
2011,Tamaulipas,Menos de 1 s.m.,381361,357902,23459,0,0,0
2011,Tamaulipas,M s de 1 hasta 2 s.m.,32848,29853,2995,0,0,0
2011,Tamaulipas,M s de 10 s.m.,1002516,464258,538258,0,0,0
2011,Tamaulipas,M s de 2 hasta 3 s.m.,466749,448350,18399,0,0,0
2011,Tamaulipas,M s de 3 hasta 5 s.m.,963068,607592,355476,0,0,0
2011,Tamaulipas,M s de 5 hasta 10 s.m.,153105,113974,39131,0,0,0
2011,Tamaulipas,No especificado,61167,30797,30370,0,0,0
2011,Tamaulipas,No recibe ingresos,259915,231954,27961,0,0,0
2011,Tlaxcala,1 salario m¡nimo,1439,1439,0,0,0,0
2011,Tlaxcala,Menos de 1 s.m.,253805,226127,27678,0,0,0
2011,Tlaxcala,M s de 1 hasta 2 s.m.,6279,5369,910,0,0,0
2011,Tlaxcala,M s de 10 s.m.,311551,145215,166336,0,0,0
2011,Tlaxcala,M s de 2 hasta 3 s.m.,170774,167424,3350,0,0,0
2011,Tlaxcala,M s de 3 hasta 5 s.m.,413634,235540,178094,0,0,0
2011,Tlaxcala,M s de 5 hasta 10 s.m.,29399,22850,6549,0,0,0
2011,Tlaxcala,No especificado,7291,4375,2916,0,0,0
2011,Tlaxcala,No recibe ingresos,54826,52820,2006,0,0,0
2011,Veracruz,1 salario m¡nimo,94341,88365,5976,0,0,0
2011,Veracruz,Menos de 1 s.m.,2769165,2618862,150303,0,0,0
2011,Veracruz,M s de 1 hasta 2 s.m.,55230,43005,12225,0,0,0
2011,Veracruz,M s de 10 s.m.,1985392,836693,1148699,0,0,0
2011,Veracruz,M s de 2 hasta 3 s.m.,1031672,1000672,31000,0,0,0
2011,Veracruz,M s de 3 hasta 5 s.m.,1215229,840024,375205,0,0,0
2011,Veracruz,M s de 5 hasta 10 s.m.,227496,183944,43552,0,0,0
2011,Veracruz,No especificado,73084,44175,28909,0,0,0
2011,Veracruz,No recibe ingresos,449445,417430,32015,0,0,0
2011,Yucat n,1 salario m¡nimo,7430,7080,350,0,0,0
2011,Yucat n,Menos de 1 s.m.,417413,394645,22768,0,0,0
2011,Yucat n,M s de 1 hasta 2 s.m.,13144,10995,2149,0,0,0
2011,Yucat n,M s de 10 s.m.,522100,233601,288499,0,0,0
2011,Yucat n,M s de 2 hasta 3 s.m.,312414,305540,6874,0,0,0
2011,Yucat n,M s de 3 hasta 5 s.m.,664070,351719,312351,0,0,0
2011,Yucat n,M s de 5 hasta 10 s.m.,96819,77490,19329,0,0,0
2011,Yucat n,No especificado,21274,15708,5566,0,0,0
2011,Yucat n,No recibe ingresos,151641,142104,9537,0,0,0
2011,Zacatecas,1 salario m¡nimo,25337,24128,1209,0,0,0
2011,Zacatecas,Menos de 1 s.m.,579754,524982,54772,0,0,0
2011,Zacatecas,M s de 1 hasta 2 s.m.,3727,3046,681,0,0,0
2011,Zacatecas,M s de 10 s.m.,399388,172090,227298,0,0,0
2011,Zacatecas,M s de 2 hasta 3 s.m.,154588,152629,1959,0,0,0
2011,Zacatecas,M s de 3 hasta 5 s.m.,243050,150227,92823,0,0,0
2011,Zacatecas,M s de 5 hasta 10 s.m.,46559,38825,7734,0,0,0
2011,Zacatecas,No especificado,8267,5590,2677,0,0,0
2011,Zacatecas,No recibe ingresos,37643,35299,2344,0,0,0
2012,Aguascalientes,1 salario m¡nimo,4779,4277,502,0,0,0
2012,Aguascalientes,Menos de 1 s.m.,121210,113544,7666,0,0,0
2012,Aguascalientes,M s de 1 hasta 2 s.m.,7622,7010,612,0,0,0
2012,Aguascalientes,M s de 10 s.m.,324347,160263,164084,0,0,0
2012,Aguascalientes,M s de 2 hasta 3 s.m.,145012,139990,5022,0,0,0
2012,Aguascalientes,M s de 3 hasta 5 s.m.,377805,259835,117970,0,0,0
2012,Aguascalientes,M s de 5 hasta 10 s.m.,60386,48515,11871,0,0,0
2012,Aguascalientes,No especificado,15137,8929,6208,0,0,0
2012,Aguascalientes,No recibe ingresos,74755,70074,4681,0,0,0
2012,Baja California,1 salario m¡nimo,7314,6818,496,0,0,0
2012,Baja California,Menos de 1 s.m.,399307,296055,103252,0,0,0
2012,Baja California,M s de 1 hasta 2 s.m.,44330,36258,8072,0,0,0
2012,Baja California,M s de 10 s.m.,1013494,538841,474653,0,0,0
2012,Baja California,M s de 2 hasta 3 s.m.,340544,327408,13136,0,0,0
2012,Baja California,M s de 3 hasta 5 s.m.,1032789,610723,422066,0,0,0
2012,Baja California,M s de 5 hasta 10 s.m.,107536,81126,26410,0,0,0
2012,Baja California,No especificado,38273,25795,12478,0,0,0
2012,Baja California,No recibe ingresos,207657,186623,21034,0,0,0
2012,Baja California Sur,1 salario m¡nimo,16469,14152,2317,0,0,0
2012,Baja California Sur,Menos de 1 s.m.,116981,96511,20470,0,0,0
2012,Baja California Sur,M s de 1 hasta 2 s.m.,22726,16850,5876,0,0,0
2012,Baja California Sur,M s de 10 s.m.,209377,95738,113639,0,0,0
2012,Baja California Sur,M s de 2 hasta 3 s.m.,97180,91770,5410,0,0,0
2012,Baja California Sur,M s de 3 hasta 5 s.m.,93449,58698,34751,0,0,0
2012,Baja California Sur,M s de 5 hasta 10 s.m.,36594,26241,10353,0,0,0
2012,Baja California Sur,No especificado,12661,8836,3825,0,0,0
2012,Baja California Sur,No recibe ingresos,40405,33698,6707,0,0,0
2012,Campeche,1 salario m¡nimo,28798,22262,6536,0,0,0
2012,Campeche,Menos de 1 s.m.,300369,285066,15303,0,0,0
2012,Campeche,M s de 1 hasta 2 s.m.,6288,5106,1182,0,0,0
2012,Campeche,M s de 10 s.m.,231906,91170,140736,0,0,0
2012,Campeche,M s de 2 hasta 3 s.m.,154948,148024,6924,0,0,0
2012,Campeche,M s de 3 hasta 5 s.m.,153642,75342,78300,0,0,0
2012,Campeche,M s de 5 hasta 10 s.m.,21902,16283,5619,0,0,0
2012,Campeche,No especificado,10505,6312,4193,0,0,0
2012,Campeche,No recibe ingresos,49475,47762,1713,0,0,0
2012,Chiapas,1 salario m¡nimo,8264,8191,73,0,0,0
2012,Chiapas,Menos de 1 s.m.,3088284,2829529,258755,0,0,0
2012,Chiapas,M s de 1 hasta 2 s.m.,18630,13477,5153,0,0,0
2012,Chiapas,M s de 10 s.m.,1032893,356257,676636,0,0,0
2012,Chiapas,M s de 2 hasta 3 s.m.,491611,478845,12766,0,0,0
2012,Chiapas,M s de 3 hasta 5 s.m.,489863,293590,196273,0,0,0
2012,Chiapas,M s de 5 hasta 10 s.m.,147153,121720,25433,0,0,0
2012,Chiapas,No especificado,29255,21590,7665,0,0,0
2012,Chiapas,No recibe ingresos,220497,213434,7063,0,0,0
2012,Chihuahua,1 salario m¡nimo,18044,16150,1894,0,0,0
2012,Chihuahua,Menos de 1 s.m.,491132,464573,26559,0,0,0
2012,Chihuahua,M s de 1 hasta 2 s.m.,42729,33494,9235,0,0,0
2012,Chihuahua,M s de 10 s.m.,980140,545888,434252,0,0,0
2012,Chihuahua,M s de 2 hasta 3 s.m.,331598,323924,7674,0,0,0
2012,Chihuahua,M s de 3 hasta 5 s.m.,1264159,791754,472405,0,0,0
2012,Chihuahua,M s de 5 hasta 10 s.m.,124928,94885,30043,0,0,0
2012,Chihuahua,No especificado,45019,33377,11642,0,0,0
2012,Chihuahua,No recibe ingresos,142476,120963,21513,0,0,0
2012,Ciudad de Mxico,1 salario m¡nimo,11389,10617,772,0,0,0
2012,Ciudad de Mxico,Menos de 1 s.m.,48757,45807,2950,0,0,0
2012,Ciudad de Mxico,M s de 1 hasta 2 s.m.,41727,29795,11932,0,0,0
2012,Ciudad de Mxico,M s de 10 s.m.,2985219,1491781,1493438,0,0,0
2012,Ciudad de Mxico,M s de 2 hasta 3 s.m.,862022,794899,67123,0,0,0
2012,Ciudad de Mxico,M s de 3 hasta 5 s.m.,1908647,1149284,759363,0,0,0
2012,Ciudad de Mxico,M s de 5 hasta 10 s.m.,449440,312667,136773,0,0,0
2012,Ciudad de Mxico,No especificado,391302,265011,126291,0,0,0
2012,Ciudad de Mxico,No recibe ingresos,913427,805692,107735,0,0,0
2012,Coahuila,1 salario m¡nimo,59501,55624,3877,0,0,0
2012,Coahuila,Menos de 1 s.m.,243613,225291,18322,0,0,0
2012,Coahuila,M s de 1 hasta 2 s.m.,19291,16441,2850,0,0,0
2012,Coahuila,M s de 10 s.m.,784697,357674,427023,0,0,0
2012,Coahuila,M s de 2 hasta 3 s.m.,369355,356240,13115,0,0,0
2012,Coahuila,M s de 3 hasta 5 s.m.,1163541,827645,335896,0,0,0
2012,Coahuila,M s de 5 hasta 10 s.m.,144244,117306,26938,0,0,0
2012,Coahuila,No especificado,45756,31911,13845,0,0,0
2012,Coahuila,No recibe ingresos,196836,180159,16677,0,0,0
2012,Colima,1 salario m¡nimo,14423,13946,477,0,0,0
2012,Colima,Menos de 1 s.m.,159855,133109,26746,0,0,0
2012,Colima,M s de 1 hasta 2 s.m.,7797,5168,2629,0,0,0
2012,Colima,M s de 10 s.m.,211722,80111,131611,0,0,0
2012,Colima,M s de 2 hasta 3 s.m.,117213,113843,3370,0,0,0
2012,Colima,M s de 3 hasta 5 s.m.,106371,60664,45707,0,0,0
2012,Colima,M s de 5 hasta 10 s.m.,31046,23472,7574,0,0,0
2012,Colima,No especificado,9366,6613,2753,0,0,0
2012,Colima,No recibe ingresos,81668,69677,11991,0,0,0
2012,Durango,1 salario m¡nimo,59914,52504,7410,0,0,0
2012,Durango,Menos de 1 s.m.,349578,339045,10533,0,0,0
2012,Durango,M s de 1 hasta 2 s.m.,7529,5995,1534,0,0,0
2012,Durango,M s de 10 s.m.,422690,163993,258697,0,0,0
2012,Durango,M s de 2 hasta 3 s.m.,238949,233146,5803,0,0,0
2012,Durango,M s de 3 hasta 5 s.m.,444102,310978,133124,0,0,0
2012,Durango,M s de 5 hasta 10 s.m.,52545,38124,14421,0,0,0
2012,Durango,No especificado,11335,7196,4139,0,0,0
2012,Durango,No recibe ingresos,105495,99165,6330,0,0,0
2012,Estado de Mxico,1 salario m¡nimo,25844,25725,119,0,0,0
2012,Estado de Mxico,Menos de 1 s.m.,1253559,1135689,117870,0,0,0
2012,Estado de Mxico,M s de 1 hasta 2 s.m.,76359,60474,15885,0,0,0
2012,Estado de Mxico,M s de 10 s.m.,5283082,2617221,2665861,0,0,0
2012,Estado de Mxico,M s de 2 hasta 3 s.m.,2186418,2114874,71544,0,0,0
2012,Estado de Mxico,M s de 3 hasta 5 s.m.,4682672,3214943,1467729,0,0,0
2012,Estado de Mxico,M s de 5 hasta 10 s.m.,612288,447238,165050,0,0,0
2012,Estado de Mxico,No especificado,260159,184783,75376,0,0,0
2012,Estado de Mxico,No recibe ingresos,1521945,1441669,80276,0,0,0
2012,Guanajuato,1 salario m¡nimo,12054,12054,0,0,0,0
2012,Guanajuato,Menos de 1 s.m.,997542,870804,126738,0,0,0
2012,Guanajuato,M s de 1 hasta 2 s.m.,29352,19636,9716,0,0,0
2012,Guanajuato,M s de 10 s.m.,1839129,779843,1059286,0,0,0
2012,Guanajuato,M s de 2 hasta 3 s.m.,695361,670952,24409,0,0,0
2012,Guanajuato,M s de 3 hasta 5 s.m.,2121069,1394816,726253,0,0,0
2012,Guanajuato,M s de 5 hasta 10 s.m.,297144,226959,70185,0,0,0
2012,Guanajuato,No especificado,43849,26378,17471,0,0,0
2012,Guanajuato,No recibe ingresos,226001,207931,18070,0,0,0
2012,Guerrero,1 salario m¡nimo,5173,4363,810,0,0,0
2012,Guerrero,Menos de 1 s.m.,1848412,1509734,338678,0,0,0
2012,Guerrero,M s de 1 hasta 2 s.m.,15439,12363,3076,0,0,0
2012,Guerrero,M s de 10 s.m.,815184,294600,520584,0,0,0
2012,Guerrero,M s de 2 hasta 3 s.m.,330767,323907,6860,0,0,0
2012,Guerrero,M s de 3 hasta 5 s.m.,511895,196505,315390,0,0,0
2012,Guerrero,M s de 5 hasta 10 s.m.,69701,55410,14291,0,0,0
2012,Guerrero,No especificado,13572,8275,5297,0,0,0
2012,Guerrero,No recibe ingresos,219631,211647,7984,0,0,0
2012,Hidalgo,1 salario m¡nimo,13499,13464,35,0,0,0
2012,Hidalgo,Menos de 1 s.m.,952647,827720,124927,0,0,0
2012,Hidalgo,M s de 1 hasta 2 s.m.,20052,15789,4263,0,0,0
2012,Hidalgo,M s de 10 s.m.,721222,325641,395581,0,0,0
2012,Hidalgo,M s de 2 hasta 3 s.m.,386758,378220,8538,0,0,0
2012,Hidalgo,M s de 3 hasta 5 s.m.,623353,385629,237724,0,0,0
2012,Hidalgo,M s de 5 hasta 10 s.m.,86187,71788,14399,0,0,0
2012,Hidalgo,No especificado,18261,11476,6785,0,0,0
2012,Hidalgo,No recibe ingresos,166520,156792,9728,0,0,0
2012,Jalisco,1 salario m¡nimo,25401,25071,330,0,0,0
2012,Jalisco,Menos de 1 s.m.,1230285,1100510,129775,0,0,0
2012,Jalisco,M s de 1 hasta 2 s.m.,20383,16476,3907,0,0,0
2012,Jalisco,M s de 10 s.m.,2529784,1138605,1391179,0,0,0
2012,Jalisco,M s de 2 hasta 3 s.m.,1017699,978252,39447,0,0,0
2012,Jalisco,M s de 3 hasta 5 s.m.,2384619,1532411,852208,0,0,0
2012,Jalisco,M s de 5 hasta 10 s.m.,354505,245827,108678,0,0,0
2012,Jalisco,No especificado,106961,68580,38381,0,0,0
2012,Jalisco,No recibe ingresos,404473,363279,41194,0,0,0
2012,Michoac n,1 salario m¡nimo,5291,5291,0,0,0,0
2012,Michoac n,Menos de 1 s.m.,1604330,1394647,209683,0,0,0
2012,Michoac n,M s de 1 hasta 2 s.m.,47230,43096,4134,0,0,0
2012,Michoac n,M s de 10 s.m.,1253244,522623,730621,0,0,0
2012,Michoac n,M s de 2 hasta 3 s.m.,589908,569830,20078,0,0,0
2012,Michoac n,M s de 3 hasta 5 s.m.,896352,508043,388309,0,0,0
2012,Michoac n,M s de 5 hasta 10 s.m.,212966,151907,61059,0,0,0
2012,Michoac n,No especificado,40667,20667,20000,0,0,0
2012,Michoac n,No recibe ingresos,243455,226266,17189,0,0,0
2012,Morelos,1 salario m¡nimo,4701,4701,0,0,0,0
2012,Morelos,Menos de 1 s.m.,360918,330157,30761,0,0,0
2012,Morelos,M s de 1 hasta 2 s.m.,9304,7449,1855,0,0,0
2012,Morelos,M s de 10 s.m.,540447,230268,310179,0,0,0
2012,Morelos,M s de 2 hasta 3 s.m.,292233,283353,8880,0,0,0
2012,Morelos,M s de 3 hasta 5 s.m.,350409,232387,118022,0,0,0
2012,Morelos,M s de 5 hasta 10 s.m.,63299,46806,16493,0,0,0
2012,Morelos,No especificado,18360,12500,5860,0,0,0
2012,Morelos,No recibe ingresos,143640,136093,7547,0,0,0
2012,Nacional,1 salario m¡nimo,888928,810202,78726,0,0,0
2012,Nacional,Menos de 1 s.m.,26491788,23399482,3092306,0,0,0
2012,Nacional,M s de 1 hasta 2 s.m.,779676,620115,159561,0,0,0
2012,Nacional,M s de 10 s.m.,33638221,15066868,18571353,0,0,0
2012,Nacional,M s de 2 hasta 3 s.m.,14515448,13988570,526878,0,0,0
2012,Nacional,M s de 3 hasta 5 s.m.,29771954,18829332,10942622,0,0,0
2012,Nacional,M s de 5 hasta 10 s.m.,4679112,3501381,1177731,0,0,0
2012,Nacional,No especificado,1580289,1052318,527971,0,0,0
2012,Nacional,No recibe ingresos,7794617,7198894,595723,0,0,0
2012,Nayarit,1 salario m¡nimo,2215,1893,322,0,0,0
2012,Nayarit,Menos de 1 s.m.,379316,355019,24297,0,0,0
2012,Nayarit,M s de 1 hasta 2 s.m.,12073,10010,2063,0,0,0
2012,Nayarit,M s de 10 s.m.,351346,124476,226870,0,0,0
2012,Nayarit,M s de 2 hasta 3 s.m.,125849,122795,3054,0,0,0
2012,Nayarit,M s de 3 hasta 5 s.m.,172138,102753,69385,0,0,0
2012,Nayarit,M s de 5 hasta 10 s.m.,47937,37246,10691,0,0,0
2012,Nayarit,No especificado,11175,7149,4026,0,0,0
2012,Nayarit,No recibe ingresos,64015,60852,3163,0,0,0
2012,Nuevo Le¢n,1 salario m¡nimo,13561,11910,1651,0,0,0
2012,Nuevo Le¢n,Menos de 1 s.m.,208241,195578,12663,0,0,0
2012,Nuevo Le¢n,M s de 1 hasta 2 s.m.,41051,31655,9396,0,0,0
2012,Nuevo Le¢n,M s de 10 s.m.,1318989,626072,692917,0,0,0
2012,Nuevo Le¢n,M s de 2 hasta 3 s.m.,705459,658072,47387,0,0,0
2012,Nuevo Le¢n,M s de 3 hasta 5 s.m.,1914618,1405881,508737,0,0,0
2012,Nuevo Le¢n,M s de 5 hasta 10 s.m.,273888,208201,65687,0,0,0
2012,Nuevo Le¢n,No especificado,83809,63980,19829,0,0,0
2012,Nuevo Le¢n,No recibe ingresos,456530,407526,49004,0,0,0
2012,Oaxaca,1 salario m¡nimo,9077,8383,694,0,0,0
2012,Oaxaca,Menos de 1 s.m.,2022218,1707272,314946,0,0,0
2012,Oaxaca,M s de 1 hasta 2 s.m.,7622,6563,1059,0,0,0
2012,Oaxaca,M s de 10 s.m.,922139,277244,644895,0,0,0
2012,Oaxaca,M s de 2 hasta 3 s.m.,382857,370971,11886,0,0,0
2012,Oaxaca,M s de 3 hasta 5 s.m.,833177,334822,498355,0,0,0
2012,Oaxaca,M s de 5 hasta 10 s.m.,97488,77303,20185,0,0,0
2012,Oaxaca,No especificado,20279,14600,5679,0,0,0
2012,Oaxaca,No recibe ingresos,211266,203001,8265,0,0,0
2012,Puebla,1 salario m¡nimo,15200,14789,411,0,0,0
2012,Puebla,Menos de 1 s.m.,2375291,1889976,485315,0,0,0
2012,Puebla,M s de 1 hasta 2 s.m.,33302,27710,5592,0,0,0
2012,Puebla,M s de 10 s.m.,1657839,716131,941708,0,0,0
2012,Puebla,M s de 2 hasta 3 s.m.,699051,686687,12364,0,0,0
2012,Puebla,M s de 3 hasta 5 s.m.,1680651,962287,718364,0,0,0
2012,Puebla,M s de 5 hasta 10 s.m.,209435,160236,49199,0,0,0
2012,Puebla,No especificado,50091,31198,18893,0,0,0
2012,Puebla,No recibe ingresos,256909,240524,16385,0,0,0
2012,Queretaro,1 salario m¡nimo,5309,5210,99,0,0,0
2012,Queretaro,Menos de 1 s.m.,246307,219899,26408,0,0,0
2012,Queretaro,M s de 1 hasta 2 s.m.,15632,11050,4582,0,0,0
2012,Queretaro,M s de 10 s.m.,439194,194416,244778,0,0,0
2012,Queretaro,M s de 2 hasta 3 s.m.,302405,293682,8723,0,0,0
2012,Queretaro,M s de 3 hasta 5 s.m.,638279,436759,201520,0,0,0
2012,Queretaro,M s de 5 hasta 10 s.m.,83984,60379,23605,0,0,0
2012,Queretaro,No especificado,20404,11574,8830,0,0,0
2012,Queretaro,No recibe ingresos,113814,99880,13934,0,0,0
2012,Quintana Roo,1 salario m¡nimo,2876,2876,0,0,0,0
2012,Quintana Roo,Menos de 1 s.m.,187212,177797,9415,0,0,0
2012,Quintana Roo,M s de 1 hasta 2 s.m.,12203,9593,2610,0,0,0
2012,Quintana Roo,M s de 10 s.m.,479066,220346,258720,0,0,0
2012,Quintana Roo,M s de 2 hasta 3 s.m.,199503,191198,8305,0,0,0
2012,Quintana Roo,M s de 3 hasta 5 s.m.,133250,81520,51730,0,0,0
2012,Quintana Roo,M s de 5 hasta 10 s.m.,58777,42696,16081,0,0,0
2012,Quintana Roo,No especificado,26095,16034,10061,0,0,0
2012,Quintana Roo,No recibe ingresos,155966,145175,10791,0,0,0
2012,San Luis Potos¡,1 salario m¡nimo,33069,30910,2159,0,0,0
2012,San Luis Potos¡,Menos de 1 s.m.,797916,739889,58027,0,0,0
2012,San Luis Potos¡,M s de 1 hasta 2 s.m.,13630,12436,1194,0,0,0
2012,San Luis Potos¡,M s de 10 s.m.,650132,283350,366782,0,0,0
2012,San Luis Potos¡,M s de 2 hasta 3 s.m.,264687,256036,8651,0,0,0
2012,San Luis Potos¡,M s de 3 hasta 5 s.m.,708885,463678,245207,0,0,0
2012,San Luis Potos¡,M s de 5 hasta 10 s.m.,105150,85509,19641,0,0,0
2012,San Luis Potos¡,No especificado,19931,10619,9312,0,0,0
2012,San Luis Potos¡,No recibe ingresos,114272,104606,9666,0,0,0
2012,Sinaloa,1 salario m¡nimo,13294,13294,0,0,0,0
2012,Sinaloa,Menos de 1 s.m.,864236,739304,124932,0,0,0
2012,Sinaloa,M s de 1 hasta 2 s.m.,29330,22131,7199,0,0,0
2012,Sinaloa,M s de 10 s.m.,974877,427782,547095,0,0,0
2012,Sinaloa,M s de 2 hasta 3 s.m.,359326,347091,12235,0,0,0
2012,Sinaloa,M s de 3 hasta 5 s.m.,462248,271734,190514,0,0,0
2012,Sinaloa,M s de 5 hasta 10 s.m.,175299,127708,47591,0,0,0
2012,Sinaloa,No especificado,36278,18415,17863,0,0,0
2012,Sinaloa,No recibe ingresos,131981,122312,9669,0,0,0
2012,Sonora,1 salario m¡nimo,74273,71287,2986,0,0,0
2012,Sonora,Menos de 1 s.m.,567445,494634,72811,0,0,0
2012,Sonora,M s de 1 hasta 2 s.m.,37817,29449,8368,0,0,0
2012,Sonora,M s de 10 s.m.,768716,341683,427033,0,0,0
2012,Sonora,M s de 2 hasta 3 s.m.,371686,358453,13233,0,0,0
2012,Sonora,M s de 3 hasta 5 s.m.,794903,464555,330348,0,0,0
2012,Sonora,M s de 5 hasta 10 s.m.,150032,116891,33141,0,0,0
2012,Sonora,No especificado,45591,28352,17239,0,0,0
2012,Sonora,No recibe ingresos,124334,115297,9037,0,0,0
2012,Tabasco,1 salario m¡nimo,202705,176172,26533,0,0,0
2012,Tabasco,Menos de 1 s.m.,550306,521933,28373,0,0,0
2012,Tabasco,M s de 1 hasta 2 s.m.,17252,13808,3444,0,0,0
2012,Tabasco,M s de 10 s.m.,623462,300673,322789,0,0,0
2012,Tabasco,M s de 2 hasta 3 s.m.,289546,282507,7039,0,0,0
2012,Tabasco,M s de 3 hasta 5 s.m.,232302,167575,64727,0,0,0
2012,Tabasco,M s de 5 hasta 10 s.m.,65176,54982,10194,0,0,0
2012,Tabasco,No especificado,16745,10259,6486,0,0,0
2012,Tabasco,No recibe ingresos,139298,136655,2643,0,0,0
2012,Tamaulipas,1 salario m¡nimo,40862,37859,3003,0,0,0
2012,Tamaulipas,Menos de 1 s.m.,366571,345716,20855,0,0,0
2012,Tamaulipas,M s de 1 hasta 2 s.m.,50495,40126,10369,0,0,0
2012,Tamaulipas,M s de 10 s.m.,1018085,478513,539572,0,0,0
2012,Tamaulipas,M s de 2 hasta 3 s.m.,501978,475036,26942,0,0,0
2012,Tamaulipas,M s de 3 hasta 5 s.m.,945583,571864,373719,0,0,0
2012,Tamaulipas,M s de 5 hasta 10 s.m.,122492,91334,31158,0,0,0
2012,Tamaulipas,No especificado,58770,33181,25589,0,0,0
2012,Tamaulipas,No recibe ingresos,278833,247991,30842,0,0,0
2012,Tlaxcala,1 salario m¡nimo,1714,1311,403,0,0,0
2012,Tlaxcala,Menos de 1 s.m.,282293,252369,29924,0,0,0
2012,Tlaxcala,M s de 1 hasta 2 s.m.,4940,3911,1029,0,0,0
2012,Tlaxcala,M s de 10 s.m.,319232,137770,181462,0,0,0
2012,Tlaxcala,M s de 2 hasta 3 s.m.,172848,169676,3172,0,0,0
2012,Tlaxcala,M s de 3 hasta 5 s.m.,436751,246153,190598,0,0,0
2012,Tlaxcala,M s de 5 hasta 10 s.m.,31737,27160,4577,0,0,0
2012,Tlaxcala,No especificado,5767,3941,1826,0,0,0
2012,Tlaxcala,No recibe ingresos,56180,54184,1996,0,0,0
2012,Veracruz,1 salario m¡nimo,111746,100943,10803,0,0,0
2012,Veracruz,Menos de 1 s.m.,3004201,2785346,218855,0,0,0
2012,Veracruz,M s de 1 hasta 2 s.m.,47200,40490,6710,0,0,0
2012,Veracruz,M s de 10 s.m.,2008212,756892,1251320,0,0,0
2012,Veracruz,M s de 2 hasta 3 s.m.,982959,950020,32939,0,0,0
2012,Veracruz,M s de 3 hasta 5 s.m.,1346302,941739,404563,0,0,0
2012,Veracruz,M s de 5 hasta 10 s.m.,241418,176866,64552,0,0,0
2012,Veracruz,No especificado,40410,30912,9498,0,0,0
2012,Veracruz,No recibe ingresos,549269,518482,30787,0,0,0
2012,Yucat n,1 salario m¡nimo,6999,6168,831,0,0,0
2012,Yucat n,Menos de 1 s.m.,464013,436510,27503,0,0,0
2012,Yucat n,M s de 1 hasta 2 s.m.,14710,11018,3692,0,0,0
2012,Yucat n,M s de 10 s.m.,534238,228364,305874,0,0,0
2012,Yucat n,M s de 2 hasta 3 s.m.,344785,337241,7544,0,0,0
2012,Yucat n,M s de 3 hasta 5 s.m.,626217,317564,308653,0,0,0
2012,Yucat n,M s de 5 hasta 10 s.m.,95981,71787,24194,0,0,0
2012,Yucat n,No especificado,22109,15346,6763,0,0,0
2012,Yucat n,No recibe ingresos,146953,137404,9549,0,0,0
2012,Zacatecas,1 salario m¡nimo,35170,31987,3183,0,0,0
2012,Zacatecas,Menos de 1 s.m.,609443,540449,68994,0,0,0
2012,Zacatecas,M s de 1 hasta 2 s.m.,5631,5288,343,0,0,0
2012,Zacatecas,M s de 10 s.m.,394117,162639,231478,0,0,0
2012,Zacatecas,M s de 2 hasta 3 s.m.,164933,161628,3305,0,0,0
2012,Zacatecas,M s de 3 hasta 5 s.m.,241913,157201,84712,0,0,0
2012,Zacatecas,M s de 5 hasta 10 s.m.,48454,36809,11645,0,0,0
2012,Zacatecas,No especificado,12397,8529,3868,0,0,0
2012,Zacatecas,No recibe ingresos,36641,34081,2560,0,0,0
2013,Aguascalientes,1 salario m¡nimo,7559,6964,595,0,0,0
2013,Aguascalientes,Menos de 1 s.m.,115217,106783,8434,0,0,0
2013,Aguascalientes,M s de 1 hasta 2 s.m.,6675,6049,626,0,0,0
2013,Aguascalientes,M s de 10 s.m.,326772,158698,168074,0,0,0
2013,Aguascalientes,M s de 2 hasta 3 s.m.,132241,125263,6978,0,0,0
2013,Aguascalientes,M s de 3 hasta 5 s.m.,436054,297958,138096,0,0,0
2013,Aguascalientes,M s de 5 hasta 10 s.m.,63517,51322,12195,0,0,0
2013,Aguascalientes,No especificado,14373,10080,4293,0,0,0
2013,Aguascalientes,No recibe ingresos,76777,71811,4966,0,0,0
2013,Baja California,1 salario m¡nimo,12006,9000,3006,0,0,0
2013,Baja California,Menos de 1 s.m.,294922,223942,70980,0,0,0
2013,Baja California,M s de 1 hasta 2 s.m.,47508,33931,13577,0,0,0
2013,Baja California,M s de 10 s.m.,1052166,552864,499302,0,0,0
2013,Baja California,M s de 2 hasta 3 s.m.,363387,354219,9168,0,0,0
2013,Baja California,M s de 3 hasta 5 s.m.,1230058,701654,528404,0,0,0
2013,Baja California,M s de 5 hasta 10 s.m.,138569,102161,36408,0,0,0
2013,Baja California,No especificado,56542,36410,20132,0,0,0
2013,Baja California,No recibe ingresos,196375,171060,25315,0,0,0
2013,Baja California Sur,1 salario m¡nimo,20209,16388,3821,0,0,0
2013,Baja California Sur,Menos de 1 s.m.,114437,97232,17205,0,0,0
2013,Baja California Sur,M s de 1 hasta 2 s.m.,14986,11295,3691,0,0,0
2013,Baja California Sur,M s de 10 s.m.,211061,97181,113880,0,0,0
2013,Baja California Sur,M s de 2 hasta 3 s.m.,111917,106394,5523,0,0,0
2013,Baja California Sur,M s de 3 hasta 5 s.m.,95547,58260,37287,0,0,0
2013,Baja California Sur,M s de 5 hasta 10 s.m.,33422,25555,7867,0,0,0
2013,Baja California Sur,No especificado,11112,7122,3990,0,0,0
2013,Baja California Sur,No recibe ingresos,39499,35615,3884,0,0,0
2013,Campeche,1 salario m¡nimo,30683,24557,6126,0,0,0
2013,Campeche,Menos de 1 s.m.,280001,268647,11354,0,0,0
2013,Campeche,M s de 1 hasta 2 s.m.,7044,5970,1074,0,0,0
2013,Campeche,M s de 10 s.m.,231529,95323,136206,0,0,0
2013,Campeche,M s de 2 hasta 3 s.m.,169178,159689,9489,0,0,0
2013,Campeche,M s de 3 hasta 5 s.m.,150494,75871,74623,0,0,0
2013,Campeche,M s de 5 hasta 10 s.m.,23889,19438,4451,0,0,0
2013,Campeche,No especificado,10177,7545,2632,0,0,0
2013,Campeche,No recibe ingresos,62734,59846,2888,0,0,0
2013,Chiapas,1 salario m¡nimo,9585,6744,2841,0,0,0
2013,Chiapas,Menos de 1 s.m.,2989911,2837957,151954,0,0,0
2013,Chiapas,M s de 1 hasta 2 s.m.,20215,17197,3018,0,0,0
2013,Chiapas,M s de 10 s.m.,1094547,400919,693628,0,0,0
2013,Chiapas,M s de 2 hasta 3 s.m.,484619,473569,11050,0,0,0
2013,Chiapas,M s de 3 hasta 5 s.m.,582965,314729,268236,0,0,0
2013,Chiapas,M s de 5 hasta 10 s.m.,128796,104372,24424,0,0,0
2013,Chiapas,No especificado,22239,17761,4478,0,0,0
2013,Chiapas,No recibe ingresos,232134,228268,3866,0,0,0
2013,Chihuahua,1 salario m¡nimo,56674,51596,5078,0,0,0
2013,Chihuahua,Menos de 1 s.m.,527515,499636,27879,0,0,0
2013,Chihuahua,M s de 1 hasta 2 s.m.,32753,27683,5070,0,0,0
2013,Chihuahua,M s de 10 s.m.,924064,473193,450871,0,0,0
2013,Chihuahua,M s de 2 hasta 3 s.m.,378894,368014,10880,0,0,0
2013,Chihuahua,M s de 3 hasta 5 s.m.,1478213,877228,600985,0,0,0
2013,Chihuahua,M s de 5 hasta 10 s.m.,133681,103329,30352,0,0,0
2013,Chihuahua,No especificado,52635,33291,19344,0,0,0
2013,Chihuahua,No recibe ingresos,159941,141379,18562,0,0,0
2013,Ciudad de Mxico,1 salario m¡nimo,4180,3327,853,0,0,0
2013,Ciudad de Mxico,Menos de 1 s.m.,49668,38610,11058,0,0,0
2013,Ciudad de Mxico,M s de 1 hasta 2 s.m.,38554,24558,13996,0,0,0
2013,Ciudad de Mxico,M s de 10 s.m.,3033968,1503854,1530114,0,0,0
2013,Ciudad de Mxico,M s de 2 hasta 3 s.m.,792929,743206,49723,0,0,0
2013,Ciudad de Mxico,M s de 3 hasta 5 s.m.,1958645,1215215,743430,0,0,0
2013,Ciudad de Mxico,M s de 5 hasta 10 s.m.,447119,313094,134025,0,0,0
2013,Ciudad de Mxico,No especificado,385221,242831,142390,0,0,0
2013,Ciudad de Mxico,No recibe ingresos,914579,821503,93076,0,0,0
2013,Coahuila,1 salario m¡nimo,58891,54519,4372,0,0,0
2013,Coahuila,Menos de 1 s.m.,222364,209067,13297,0,0,0
2013,Coahuila,M s de 1 hasta 2 s.m.,23930,19713,4217,0,0,0
2013,Coahuila,M s de 10 s.m.,802323,359456,442867,0,0,0
2013,Coahuila,M s de 2 hasta 3 s.m.,387694,374628,13066,0,0,0
2013,Coahuila,M s de 3 hasta 5 s.m.,1245862,883574,362288,0,0,0
2013,Coahuila,M s de 5 hasta 10 s.m.,146910,109125,37785,0,0,0
2013,Coahuila,No especificado,39456,29979,9477,0,0,0
2013,Coahuila,No recibe ingresos,170787,155903,14884,0,0,0
2013,Colima,1 salario m¡nimo,10695,9609,1086,0,0,0
2013,Colima,Menos de 1 s.m.,144018,123138,20880,0,0,0
2013,Colima,M s de 1 hasta 2 s.m.,7136,5690,1446,0,0,0
2013,Colima,M s de 10 s.m.,215008,86223,128785,0,0,0
2013,Colima,M s de 2 hasta 3 s.m.,108153,103495,4658,0,0,0
2013,Colima,M s de 3 hasta 5 s.m.,117673,69700,47973,0,0,0
2013,Colima,M s de 5 hasta 10 s.m.,39081,28526,10555,0,0,0
2013,Colima,No especificado,10501,7660,2841,0,0,0
2013,Colima,No recibe ingresos,84162,69577,14585,0,0,0
2013,Durango,1 salario m¡nimo,50310,46774,3536,0,0,0
2013,Durango,Menos de 1 s.m.,410458,394676,15782,0,0,0
2013,Durango,M s de 1 hasta 2 s.m.,6385,4431,1954,0,0,0
2013,Durango,M s de 10 s.m.,471986,185439,286547,0,0,0
2013,Durango,M s de 2 hasta 3 s.m.,199221,193212,6009,0,0,0
2013,Durango,M s de 3 hasta 5 s.m.,477339,340112,137227,0,0,0
2013,Durango,M s de 5 hasta 10 s.m.,61307,46768,14539,0,0,0
2013,Durango,No especificado,12130,5860,6270,0,0,0
2013,Durango,No recibe ingresos,108820,103908,4912,0,0,0
2013,Estado de Mxico,1 salario m¡nimo,24433,24433,0,0,0,0
2013,Estado de Mxico,Menos de 1 s.m.,1294139,1155379,138760,0,0,0
2013,Estado de Mxico,M s de 1 hasta 2 s.m.,54880,49131,5749,0,0,0
2013,Estado de Mxico,M s de 10 s.m.,5282303,2558507,2723796,0,0,0
2013,Estado de Mxico,M s de 2 hasta 3 s.m.,2246526,2194537,51989,0,0,0
2013,Estado de Mxico,M s de 3 hasta 5 s.m.,4882982,3355179,1527803,0,0,0
2013,Estado de Mxico,M s de 5 hasta 10 s.m.,605457,432223,173234,0,0,0
2013,Estado de Mxico,No especificado,286137,227638,58499,0,0,0
2013,Estado de Mxico,No recibe ingresos,1579533,1492710,86823,0,0,0
2013,Guanajuato,1 salario m¡nimo,24798,24693,105,0,0,0
2013,Guanajuato,Menos de 1 s.m.,1046785,918981,127804,0,0,0
2013,Guanajuato,M s de 1 hasta 2 s.m.,31666,21917,9749,0,0,0
2013,Guanajuato,M s de 10 s.m.,1707969,723143,984826,0,0,0
2013,Guanajuato,M s de 2 hasta 3 s.m.,711833,690468,21365,0,0,0
2013,Guanajuato,M s de 3 hasta 5 s.m.,2177530,1401058,776472,0,0,0
2013,Guanajuato,M s de 5 hasta 10 s.m.,302587,235967,66620,0,0,0
2013,Guanajuato,No especificado,45232,31900,13332,0,0,0
2013,Guanajuato,No recibe ingresos,231207,217483,13724,0,0,0
2013,Guerrero,1 salario m¡nimo,10307,8459,1848,0,0,0
2013,Guerrero,Menos de 1 s.m.,1685550,1425854,259696,0,0,0
2013,Guerrero,M s de 1 hasta 2 s.m.,20971,17836,3135,0,0,0
2013,Guerrero,M s de 10 s.m.,822885,286456,536429,0,0,0
2013,Guerrero,M s de 2 hasta 3 s.m.,344302,338814,5488,0,0,0
2013,Guerrero,M s de 3 hasta 5 s.m.,439884,182973,256911,0,0,0
2013,Guerrero,M s de 5 hasta 10 s.m.,87108,69741,17367,0,0,0
2013,Guerrero,No especificado,13250,9526,3724,0,0,0
2013,Guerrero,No recibe ingresos,204001,199556,4445,0,0,0
2013,Hidalgo,1 salario m¡nimo,16655,15670,985,0,0,0
2013,Hidalgo,Menos de 1 s.m.,973203,848464,124739,0,0,0
2013,Hidalgo,M s de 1 hasta 2 s.m.,21937,14616,7321,0,0,0
2013,Hidalgo,M s de 10 s.m.,753451,352585,400866,0,0,0
2013,Hidalgo,M s de 2 hasta 3 s.m.,371454,360705,10749,0,0,0
2013,Hidalgo,M s de 3 hasta 5 s.m.,615730,371270,244460,0,0,0
2013,Hidalgo,M s de 5 hasta 10 s.m.,90251,74316,15935,0,0,0
2013,Hidalgo,No especificado,17872,9548,8324,0,0,0
2013,Hidalgo,No recibe ingresos,156567,152111,4456,0,0,0
2013,Jalisco,1 salario m¡nimo,13033,12905,128,0,0,0
2013,Jalisco,Menos de 1 s.m.,1250991,1122800,128191,0,0,0
2013,Jalisco,M s de 1 hasta 2 s.m.,47175,35206,11969,0,0,0
2013,Jalisco,M s de 10 s.m.,2545296,1160489,1384807,0,0,0
2013,Jalisco,M s de 2 hasta 3 s.m.,926983,896095,30888,0,0,0
2013,Jalisco,M s de 3 hasta 5 s.m.,2427290,1533803,893487,0,0,0
2013,Jalisco,M s de 5 hasta 10 s.m.,368783,279568,89215,0,0,0
2013,Jalisco,No especificado,120174,69058,51116,0,0,0
2013,Jalisco,No recibe ingresos,404805,354960,49845,0,0,0
2013,Michoac n,1 salario m¡nimo,10518,10518,0,0,0,0
2013,Michoac n,Menos de 1 s.m.,1659624,1486835,172789,0,0,0
2013,Michoac n,M s de 1 hasta 2 s.m.,23260,22407,853,0,0,0
2013,Michoac n,M s de 10 s.m.,1294830,519247,775583,0,0,0
2013,Michoac n,M s de 2 hasta 3 s.m.,513615,505501,8114,0,0,0
2013,Michoac n,M s de 3 hasta 5 s.m.,977464,602111,375353,0,0,0
2013,Michoac n,M s de 5 hasta 10 s.m.,194891,141920,52971,0,0,0
2013,Michoac n,No especificado,32204,19139,13065,0,0,0
2013,Michoac n,No recibe ingresos,215225,208243,6982,0,0,0
2013,Morelos,1 salario m¡nimo,6611,6471,140,0,0,0
2013,Morelos,Menos de 1 s.m.,331318,306538,24780,0,0,0
2013,Morelos,M s de 1 hasta 2 s.m.,10736,9170,1566,0,0,0
2013,Morelos,M s de 10 s.m.,598385,252952,345433,0,0,0
2013,Morelos,M s de 2 hasta 3 s.m.,273707,269317,4390,0,0,0
2013,Morelos,M s de 3 hasta 5 s.m.,378293,231785,146508,0,0,0
2013,Morelos,M s de 5 hasta 10 s.m.,54905,42664,12241,0,0,0
2013,Morelos,No especificado,13501,7915,5586,0,0,0
2013,Morelos,No recibe ingresos,139867,131016,8851,0,0,0
2013,Nacional,1 salario m¡nimo,984052,876809,107243,0,0,0
2013,Nacional,Menos de 1 s.m.,26662103,23704448,2957655,0,0,0
2013,Nacional,M s de 1 hasta 2 s.m.,746806,594672,152134,0,0,0
2013,Nacional,M s de 10 s.m.,33854861,15109321,18745540,0,0,0
2013,Nacional,M s de 2 hasta 3 s.m.,14399883,13937033,462850,0,0,0
2013,Nacional,M s de 3 hasta 5 s.m.,30843248,19454852,11388396,0,0,0
2013,Nacional,M s de 5 hasta 10 s.m.,4746592,3563834,1182758,0,0,0
2013,Nacional,No especificado,1667175,1119540,547635,0,0,0
2013,Nacional,No recibe ingresos,8027133,7427334,599799,0,0,0
2013,Nayarit,1 salario m¡nimo,2283,2074,209,0,0,0
2013,Nayarit,Menos de 1 s.m.,388341,361885,26456,0,0,0
2013,Nayarit,M s de 1 hasta 2 s.m.,10299,8915,1384,0,0,0
2013,Nayarit,M s de 10 s.m.,384384,135043,249341,0,0,0
2013,Nayarit,M s de 2 hasta 3 s.m.,127550,123857,3693,0,0,0
2013,Nayarit,M s de 3 hasta 5 s.m.,147361,86361,61000,0,0,0
2013,Nayarit,M s de 5 hasta 10 s.m.,43752,33300,10452,0,0,0
2013,Nayarit,No especificado,14264,8407,5857,0,0,0
2013,Nayarit,No recibe ingresos,63002,59154,3848,0,0,0
2013,Nuevo Le¢n,1 salario m¡nimo,8721,7765,956,0,0,0
2013,Nuevo Le¢n,Menos de 1 s.m.,175720,163152,12568,0,0,0
2013,Nuevo Le¢n,M s de 1 hasta 2 s.m.,41373,33242,8131,0,0,0
2013,Nuevo Le¢n,M s de 10 s.m.,1378154,685488,692666,0,0,0
2013,Nuevo Le¢n,M s de 2 hasta 3 s.m.,724290,681424,42866,0,0,0
2013,Nuevo Le¢n,M s de 3 hasta 5 s.m.,1996029,1457248,538781,0,0,0
2013,Nuevo Le¢n,M s de 5 hasta 10 s.m.,288899,214495,74404,0,0,0
2013,Nuevo Le¢n,No especificado,94740,64668,30072,0,0,0
2013,Nuevo Le¢n,No recibe ingresos,483112,437858,45254,0,0,0
2013,Oaxaca,1 salario m¡nimo,8457,8457,0,0,0,0
2013,Oaxaca,Menos de 1 s.m.,2016943,1689691,327252,0,0,0
2013,Oaxaca,M s de 1 hasta 2 s.m.,8862,7717,1145,0,0,0
2013,Oaxaca,M s de 10 s.m.,892150,283411,608739,0,0,0
2013,Oaxaca,M s de 2 hasta 3 s.m.,416152,408210,7942,0,0,0
2013,Oaxaca,M s de 3 hasta 5 s.m.,769029,314435,454594,0,0,0
2013,Oaxaca,M s de 5 hasta 10 s.m.,81017,66408,14609,0,0,0
2013,Oaxaca,No especificado,18642,11769,6873,0,0,0
2013,Oaxaca,No recibe ingresos,217964,209788,8176,0,0,0
2013,Puebla,1 salario m¡nimo,18740,17734,1006,0,0,0
2013,Puebla,Menos de 1 s.m.,2639295,2117452,521843,0,0,0
2013,Puebla,M s de 1 hasta 2 s.m.,26045,20374,5671,0,0,0
2013,Puebla,M s de 10 s.m.,1712346,721133,991213,0,0,0
2013,Puebla,M s de 2 hasta 3 s.m.,627405,608557,18848,0,0,0
2013,Puebla,M s de 3 hasta 5 s.m.,1456904,868897,588007,0,0,0
2013,Puebla,M s de 5 hasta 10 s.m.,218259,167149,51110,0,0,0
2013,Puebla,No especificado,63555,46052,17503,0,0,0
2013,Puebla,No recibe ingresos,323675,295810,27865,0,0,0
2013,Queretaro,1 salario m¡nimo,4216,4119,97,0,0,0
2013,Queretaro,Menos de 1 s.m.,213535,189260,24275,0,0,0
2013,Queretaro,M s de 1 hasta 2 s.m.,14327,10976,3351,0,0,0
2013,Queretaro,M s de 10 s.m.,417322,190337,226985,0,0,0
2013,Queretaro,M s de 2 hasta 3 s.m.,283814,274850,8964,0,0,0
2013,Queretaro,M s de 3 hasta 5 s.m.,628258,422243,206015,0,0,0
2013,Queretaro,M s de 5 hasta 10 s.m.,92361,69689,22672,0,0,0
2013,Queretaro,No especificado,27640,19803,7837,0,0,0
2013,Queretaro,No recibe ingresos,126982,112349,14633,0,0,0
2013,Quintana Roo,1 salario m¡nimo,3652,3652,0,0,0,0
2013,Quintana Roo,Menos de 1 s.m.,189160,176667,12493,0,0,0
2013,Quintana Roo,M s de 1 hasta 2 s.m.,12246,9117,3129,0,0,0
2013,Quintana Roo,M s de 10 s.m.,463989,209246,254743,0,0,0
2013,Quintana Roo,M s de 2 hasta 3 s.m.,206371,197340,9031,0,0,0
2013,Quintana Roo,M s de 3 hasta 5 s.m.,141251,93188,48063,0,0,0
2013,Quintana Roo,M s de 5 hasta 10 s.m.,77982,54648,23334,0,0,0
2013,Quintana Roo,No especificado,24365,16305,8060,0,0,0
2013,Quintana Roo,No recibe ingresos,158644,145346,13298,0,0,0
2013,San Luis Potos¡,1 salario m¡nimo,43446,40491,2955,0,0,0
2013,San Luis Potos¡,Menos de 1 s.m.,797239,731562,65677,0,0,0
2013,San Luis Potos¡,M s de 1 hasta 2 s.m.,15607,12994,2613,0,0,0
2013,San Luis Potos¡,M s de 10 s.m.,677777,285310,392467,0,0,0
2013,San Luis Potos¡,M s de 2 hasta 3 s.m.,303653,292349,11304,0,0,0
2013,San Luis Potos¡,M s de 3 hasta 5 s.m.,728914,466461,262453,0,0,0
2013,San Luis Potos¡,M s de 5 hasta 10 s.m.,105496,83651,21845,0,0,0
2013,San Luis Potos¡,No especificado,19456,11604,7852,0,0,0
2013,San Luis Potos¡,No recibe ingresos,136836,127241,9595,0,0,0
2013,Sinaloa,1 salario m¡nimo,12537,12537,0,0,0,0
2013,Sinaloa,Menos de 1 s.m.,948117,791483,156634,0,0,0
2013,Sinaloa,M s de 1 hasta 2 s.m.,30089,23733,6356,0,0,0
2013,Sinaloa,M s de 10 s.m.,888790,385743,503047,0,0,0
2013,Sinaloa,M s de 2 hasta 3 s.m.,373863,355675,18188,0,0,0
2013,Sinaloa,M s de 3 hasta 5 s.m.,485804,285950,199854,0,0,0
2013,Sinaloa,M s de 5 hasta 10 s.m.,172416,124533,47883,0,0,0
2013,Sinaloa,No especificado,36566,22614,13952,0,0,0
2013,Sinaloa,No recibe ingresos,134742,125570,9172,0,0,0
2013,Sonora,1 salario m¡nimo,99446,95969,3477,0,0,0
2013,Sonora,Menos de 1 s.m.,493982,424904,69078,0,0,0
2013,Sonora,M s de 1 hasta 2 s.m.,24748,18033,6715,0,0,0
2013,Sonora,M s de 10 s.m.,798385,351068,447317,0,0,0
2013,Sonora,M s de 2 hasta 3 s.m.,391248,372773,18475,0,0,0
2013,Sonora,M s de 3 hasta 5 s.m.,845830,477305,368525,0,0,0
2013,Sonora,M s de 5 hasta 10 s.m.,159204,113043,46161,0,0,0
2013,Sonora,No especificado,55452,33861,21591,0,0,0
2013,Sonora,No recibe ingresos,135142,122818,12324,0,0,0
2013,Tabasco,1 salario m¡nimo,187183,157202,29981,0,0,0
2013,Tabasco,Menos de 1 s.m.,581911,555770,26141,0,0,0
2013,Tabasco,M s de 1 hasta 2 s.m.,13536,9519,4017,0,0,0
2013,Tabasco,M s de 10 s.m.,641975,296472,345503,0,0,0
2013,Tabasco,M s de 2 hasta 3 s.m.,288975,280230,8745,0,0,0
2013,Tabasco,M s de 3 hasta 5 s.m.,231548,168330,63218,0,0,0
2013,Tabasco,M s de 5 hasta 10 s.m.,84756,69394,15362,0,0,0
2013,Tabasco,No especificado,17776,10460,7316,0,0,0
2013,Tabasco,No recibe ingresos,165742,161308,4434,0,0,0
2013,Tamaulipas,1 salario m¡nimo,72243,62419,9824,0,0,0
2013,Tamaulipas,Menos de 1 s.m.,405818,376397,29421,0,0,0
2013,Tamaulipas,M s de 1 hasta 2 s.m.,46282,38000,8282,0,0,0
2013,Tamaulipas,M s de 10 s.m.,1056032,510910,545122,0,0,0
2013,Tamaulipas,M s de 2 hasta 3 s.m.,474304,452697,21607,0,0,0
2013,Tamaulipas,M s de 3 hasta 5 s.m.,1098306,674000,424306,0,0,0
2013,Tamaulipas,M s de 5 hasta 10 s.m.,115687,79805,35882,0,0,0
2013,Tamaulipas,No especificado,53712,27560,26152,0,0,0
2013,Tamaulipas,No recibe ingresos,302355,256916,45439,0,0,0
2013,Tlaxcala,1 salario m¡nimo,518,518,0,0,0,0
2013,Tlaxcala,Menos de 1 s.m.,294658,261969,32689,0,0,0
2013,Tlaxcala,M s de 1 hasta 2 s.m.,1822,1722,100,0,0,0
2013,Tlaxcala,M s de 10 s.m.,339161,140628,198533,0,0,0
2013,Tlaxcala,M s de 2 hasta 3 s.m.,164655,163831,824,0,0,0
2013,Tlaxcala,M s de 3 hasta 5 s.m.,475717,259072,216645,0,0,0
2013,Tlaxcala,M s de 5 hasta 10 s.m.,30897,25733,5164,0,0,0
2013,Tlaxcala,No especificado,5771,4057,1714,0,0,0
2013,Tlaxcala,No recibe ingresos,60477,57542,2935,0,0,0
2013,Veracruz,1 salario m¡nimo,104800,83618,21182,0,0,0
2013,Veracruz,Menos de 1 s.m.,3049070,2820676,228394,0,0,0
2013,Veracruz,M s de 1 hasta 2 s.m.,62368,54551,7817,0,0,0
2013,Veracruz,M s de 10 s.m.,1865331,730986,1134345,0,0,0
2013,Veracruz,M s de 2 hasta 3 s.m.,1009605,990381,19224,0,0,0
2013,Veracruz,M s de 3 hasta 5 s.m.,1282453,874929,407524,0,0,0
2013,Veracruz,M s de 5 hasta 10 s.m.,212903,170202,42701,0,0,0
2013,Veracruz,No especificado,60325,46861,13464,0,0,0
2013,Veracruz,No recibe ingresos,564734,538548,26186,0,0,0
2013,Yucat n,1 salario m¡nimo,5784,5784,0,0,0,0
2013,Yucat n,Menos de 1 s.m.,435799,408258,27541,0,0,0
2013,Yucat n,M s de 1 hasta 2 s.m.,18073,14185,3888,0,0,0
2013,Yucat n,M s de 10 s.m.,583919,250927,332992,0,0,0
2013,Yucat n,M s de 2 hasta 3 s.m.,327063,316662,10401,0,0,0
2013,Yucat n,M s de 3 hasta 5 s.m.,668502,352633,315869,0,0,0
2013,Yucat n,M s de 5 hasta 10 s.m.,103713,79592,24121,0,0,0
2013,Yucat n,No especificado,22134,16276,5858,0,0,0
2013,Yucat n,No recibe ingresos,143396,132067,11329,0,0,0
2013,Zacatecas,1 salario m¡nimo,44879,41843,3036,0,0,0
2013,Zacatecas,Menos de 1 s.m.,642394,570783,71611,0,0,0
2013,Zacatecas,M s de 1 hasta 2 s.m.,5318,4794,524,0,0,0
2013,Zacatecas,M s de 10 s.m.,386603,166090,220513,0,0,0
2013,Zacatecas,M s de 2 hasta 3 s.m.,164282,161071,3211,0,0,0
2013,Zacatecas,M s de 3 hasta 5 s.m.,215319,141320,73999,0,0,0
2013,Zacatecas,M s de 5 hasta 10 s.m.,38977,32103,6874,0,0,0
2013,Zacatecas,No especificado,10021,5980,4041,0,0,0
2013,Zacatecas,No recibe ingresos,33317,30070,3247,0,0,0
2014,Aguascalientes,1 salario m¡nimo,5946,5628,318,0,0,0
2014,Aguascalientes,Menos de 1 s.m.,114684,108579,6105,0,0,0
2014,Aguascalientes,M s de 1 hasta 2 s.m.,8373,6694,1679,0,0,0
2014,Aguascalientes,M s de 10 s.m.,320177,158784,161393,0,0,0
2014,Aguascalientes,M s de 2 hasta 3 s.m.,135677,127589,8088,0,0,0
2014,Aguascalientes,M s de 3 hasta 5 s.m.,455568,314099,141469,0,0,0
2014,Aguascalientes,M s de 5 hasta 10 s.m.,75168,59384,15784,0,0,0
2014,Aguascalientes,No especificado,12434,8067,4367,0,0,0
2014,Aguascalientes,No recibe ingresos,75220,69689,5531,0,0,0
2014,Baja California,1 salario m¡nimo,6184,6184,0,0,0,0
2014,Baja California,Menos de 1 s.m.,265863,203809,62054,0,0,0
2014,Baja California,M s de 1 hasta 2 s.m.,35251,28129,7122,0,0,0
2014,Baja California,M s de 10 s.m.,1014697,516811,497886,0,0,0
2014,Baja California,M s de 2 hasta 3 s.m.,351674,337877,13797,0,0,0
2014,Baja California,M s de 3 hasta 5 s.m.,1505613,889745,615868,0,0,0
2014,Baja California,M s de 5 hasta 10 s.m.,162697,122759,39938,0,0,0
2014,Baja California,No especificado,47484,29122,18362,0,0,0
2014,Baja California,No recibe ingresos,200163,178320,21843,0,0,0
2014,Baja California Sur,1 salario m¡nimo,15380,12118,3262,0,0,0
2014,Baja California Sur,Menos de 1 s.m.,155955,123907,32048,0,0,0
2014,Baja California Sur,M s de 1 hasta 2 s.m.,9571,7074,2497,0,0,0
2014,Baja California Sur,M s de 10 s.m.,224423,109636,114787,0,0,0
2014,Baja California Sur,M s de 2 hasta 3 s.m.,128049,122121,5928,0,0,0
2014,Baja California Sur,M s de 3 hasta 5 s.m.,88755,57458,31297,0,0,0
2014,Baja California Sur,M s de 5 hasta 10 s.m.,34166,24784,9382,0,0,0
2014,Baja California Sur,No especificado,8604,5486,3118,0,0,0
2014,Baja California Sur,No recibe ingresos,47230,40704,6526,0,0,0
2014,Campeche,1 salario m¡nimo,35721,26750,8971,0,0,0
2014,Campeche,Menos de 1 s.m.,298675,285160,13515,0,0,0
2014,Campeche,M s de 1 hasta 2 s.m.,6471,6050,421,0,0,0
2014,Campeche,M s de 10 s.m.,234167,97462,136705,0,0,0
2014,Campeche,M s de 2 hasta 3 s.m.,165491,156767,8724,0,0,0
2014,Campeche,M s de 3 hasta 5 s.m.,139886,71814,68072,0,0,0
2014,Campeche,M s de 5 hasta 10 s.m.,23144,19434,3710,0,0,0
2014,Campeche,No especificado,9715,7612,2103,0,0,0
2014,Campeche,No recibe ingresos,53859,50526,3333,0,0,0
2014,Chiapas,1 salario m¡nimo,21029,19255,1774,0,0,0
2014,Chiapas,Menos de 1 s.m.,2880010,2757255,122755,0,0,0
2014,Chiapas,M s de 1 hasta 2 s.m.,15808,13155,2653,0,0,0
2014,Chiapas,M s de 10 s.m.,996927,403374,593553,0,0,0
2014,Chiapas,M s de 2 hasta 3 s.m.,487176,478274,8902,0,0,0
2014,Chiapas,M s de 3 hasta 5 s.m.,546393,285550,260843,0,0,0
2014,Chiapas,M s de 5 hasta 10 s.m.,145919,112447,33472,0,0,0
2014,Chiapas,No especificado,13004,9122,3882,0,0,0
2014,Chiapas,No recibe ingresos,246695,243145,3550,0,0,0
2014,Chihuahua,1 salario m¡nimo,93101,87706,5395,0,0,0
2014,Chihuahua,Menos de 1 s.m.,581787,543424,38363,0,0,0
2014,Chihuahua,M s de 1 hasta 2 s.m.,22562,17060,5502,0,0,0
2014,Chihuahua,M s de 10 s.m.,867818,445284,422534,0,0,0
2014,Chihuahua,M s de 2 hasta 3 s.m.,422996,406388,16608,0,0,0
2014,Chihuahua,M s de 3 hasta 5 s.m.,1645520,1019428,626092,0,0,0
2014,Chihuahua,M s de 5 hasta 10 s.m.,161058,114486,46572,0,0,0
2014,Chihuahua,No especificado,44009,29233,14776,0,0,0
2014,Chihuahua,No recibe ingresos,186026,169843,16183,0,0,0
2014,Ciudad de Mxico,1 salario m¡nimo,5751,5751,0,0,0,0
2014,Ciudad de Mxico,Menos de 1 s.m.,80594,61712,18882,0,0,0
2014,Ciudad de Mxico,M s de 1 hasta 2 s.m.,54399,35306,19093,0,0,0
2014,Ciudad de Mxico,M s de 10 s.m.,2928726,1487124,1441602,0,0,0
2014,Ciudad de Mxico,M s de 2 hasta 3 s.m.,868962,805728,63234,0,0,0
2014,Ciudad de Mxico,M s de 3 hasta 5 s.m.,1750451,1131899,618552,0,0,0
2014,Ciudad de Mxico,M s de 5 hasta 10 s.m.,463017,313390,149627,0,0,0
2014,Ciudad de Mxico,No especificado,291114,173208,117906,0,0,0
2014,Ciudad de Mxico,No recibe ingresos,919286,824146,95140,0,0,0
2014,Coahuila,1 salario m¡nimo,52223,47725,4498,0,0,0
2014,Coahuila,Menos de 1 s.m.,232605,212513,20092,0,0,0
2014,Coahuila,M s de 1 hasta 2 s.m.,23198,17407,5791,0,0,0
2014,Coahuila,M s de 10 s.m.,743330,327215,416115,0,0,0
2014,Coahuila,M s de 2 hasta 3 s.m.,389225,368919,20306,0,0,0
2014,Coahuila,M s de 3 hasta 5 s.m.,1364749,948833,415916,0,0,0
2014,Coahuila,M s de 5 hasta 10 s.m.,133321,104728,28593,0,0,0
2014,Coahuila,No especificado,41514,26375,15139,0,0,0
2014,Coahuila,No recibe ingresos,218073,202907,15166,0,0,0
2014,Colima,1 salario m¡nimo,7269,5226,2043,0,0,0
2014,Colima,Menos de 1 s.m.,154595,130993,23602,0,0,0
2014,Colima,M s de 1 hasta 2 s.m.,10518,9009,1509,0,0,0
2014,Colima,M s de 10 s.m.,201304,79845,121459,0,0,0
2014,Colima,M s de 2 hasta 3 s.m.,108868,104429,4439,0,0,0
2014,Colima,M s de 3 hasta 5 s.m.,114226,66601,47625,0,0,0
2014,Colima,M s de 5 hasta 10 s.m.,37427,28252,9175,0,0,0
2014,Colima,No especificado,8353,5872,2481,0,0,0
2014,Colima,No recibe ingresos,91983,75046,16937,0,0,0
2014,Durango,1 salario m¡nimo,43578,39712,3866,0,0,0
2014,Durango,Menos de 1 s.m.,461456,441089,20367,0,0,0
2014,Durango,M s de 1 hasta 2 s.m.,7863,6704,1159,0,0,0
2014,Durango,M s de 10 s.m.,448461,176396,272065,0,0,0
2014,Durango,M s de 2 hasta 3 s.m.,213137,206402,6735,0,0,0
2014,Durango,M s de 3 hasta 5 s.m.,440564,300446,140118,0,0,0
2014,Durango,M s de 5 hasta 10 s.m.,62045,47684,14361,0,0,0
2014,Durango,No especificado,16905,10869,6036,0,0,0
2014,Durango,No recibe ingresos,107604,102168,5436,0,0,0
2014,Estado de Mxico,1 salario m¡nimo,15223,12310,2913,0,0,0
2014,Estado de Mxico,Menos de 1 s.m.,1287763,1190861,96902,0,0,0
2014,Estado de Mxico,M s de 1 hasta 2 s.m.,78273,71499,6774,0,0,0
2014,Estado de Mxico,M s de 10 s.m.,5335920,2624131,2711789,0,0,0
2014,Estado de Mxico,M s de 2 hasta 3 s.m.,2320258,2260946,59312,0,0,0
2014,Estado de Mxico,M s de 3 hasta 5 s.m.,4958248,3400682,1557566,0,0,0
2014,Estado de Mxico,M s de 5 hasta 10 s.m.,721898,548976,172922,0,0,0
2014,Estado de Mxico,No especificado,238913,173897,65016,0,0,0
2014,Estado de Mxico,No recibe ingresos,1767013,1648277,118736,0,0,0
2014,Guanajuato,1 salario m¡nimo,22835,22164,671,0,0,0
2014,Guanajuato,Menos de 1 s.m.,1047275,936104,111171,0,0,0
2014,Guanajuato,M s de 1 hasta 2 s.m.,25812,21099,4713,0,0,0
2014,Guanajuato,M s de 10 s.m.,1568920,627690,941230,0,0,0
2014,Guanajuato,M s de 2 hasta 3 s.m.,720372,694474,25898,0,0,0
2014,Guanajuato,M s de 3 hasta 5 s.m.,2323411,1576889,746522,0,0,0
2014,Guanajuato,M s de 5 hasta 10 s.m.,346114,269841,76273,0,0,0
2014,Guanajuato,No especificado,35466,21854,13612,0,0,0
2014,Guanajuato,No recibe ingresos,247446,230842,16604,0,0,0
2014,Guerrero,1 salario m¡nimo,16566,11933,4633,0,0,0
2014,Guerrero,Menos de 1 s.m.,1714208,1473846,240362,0,0,0
2014,Guerrero,M s de 1 hasta 2 s.m.,19058,15497,3561,0,0,0
2014,Guerrero,M s de 10 s.m.,804637,286081,518556,0,0,0
2014,Guerrero,M s de 2 hasta 3 s.m.,378796,373035,5761,0,0,0
2014,Guerrero,M s de 3 hasta 5 s.m.,517671,234093,283578,0,0,0
2014,Guerrero,M s de 5 hasta 10 s.m.,98974,82204,16770,0,0,0
2014,Guerrero,No especificado,13163,8839,4324,0,0,0
2014,Guerrero,No recibe ingresos,211287,205166,6121,0,0,0
2014,Hidalgo,1 salario m¡nimo,23328,20813,2515,0,0,0
2014,Hidalgo,Menos de 1 s.m.,918601,811119,107482,0,0,0
2014,Hidalgo,M s de 1 hasta 2 s.m.,13969,9034,4935,0,0,0
2014,Hidalgo,M s de 10 s.m.,710000,311251,398749,0,0,0
2014,Hidalgo,M s de 2 hasta 3 s.m.,368677,357038,11639,0,0,0
2014,Hidalgo,M s de 3 hasta 5 s.m.,675906,405440,270466,0,0,0
2014,Hidalgo,M s de 5 hasta 10 s.m.,104524,83684,20840,0,0,0
2014,Hidalgo,No especificado,15139,8937,6202,0,0,0
2014,Hidalgo,No recibe ingresos,156173,150152,6021,0,0,0
2014,Jalisco,1 salario m¡nimo,8102,8102,0,0,0,0
2014,Jalisco,Menos de 1 s.m.,1292781,1174346,118435,0,0,0
2014,Jalisco,M s de 1 hasta 2 s.m.,42386,31008,11378,0,0,0
2014,Jalisco,M s de 10 s.m.,2473040,1131957,1341083,0,0,0
2014,Jalisco,M s de 2 hasta 3 s.m.,938306,910351,27955,0,0,0
2014,Jalisco,M s de 3 hasta 5 s.m.,2421547,1533160,888387,0,0,0
2014,Jalisco,M s de 5 hasta 10 s.m.,442524,316242,126282,0,0,0
2014,Jalisco,No especificado,98663,71203,27460,0,0,0
2014,Jalisco,No recibe ingresos,410149,379676,30473,0,0,0
2014,Michoac n,1 salario m¡nimo,5586,5586,0,0,0,0
2014,Michoac n,Menos de 1 s.m.,1792670,1635859,156811,0,0,0
2014,Michoac n,M s de 1 hasta 2 s.m.,33782,30726,3056,0,0,0
2014,Michoac n,M s de 10 s.m.,1306055,498700,807355,0,0,0
2014,Michoac n,M s de 2 hasta 3 s.m.,508189,498703,9486,0,0,0
2014,Michoac n,M s de 3 hasta 5 s.m.,953582,579907,373675,0,0,0
2014,Michoac n,M s de 5 hasta 10 s.m.,237443,196045,41398,0,0,0
2014,Michoac n,No especificado,41493,25927,15566,0,0,0
2014,Michoac n,No recibe ingresos,216278,205920,10358,0,0,0
2014,Morelos,1 salario m¡nimo,3427,2710,717,0,0,0
2014,Morelos,Menos de 1 s.m.,336356,305126,31230,0,0,0
2014,Morelos,M s de 1 hasta 2 s.m.,12901,10946,1955,0,0,0
2014,Morelos,M s de 10 s.m.,581418,252963,328455,0,0,0
2014,Morelos,M s de 2 hasta 3 s.m.,274029,267084,6945,0,0,0
2014,Morelos,M s de 3 hasta 5 s.m.,346947,221670,125277,0,0,0
2014,Morelos,M s de 5 hasta 10 s.m.,67669,49902,17767,0,0,0
2014,Morelos,No especificado,24829,16615,8214,0,0,0
2014,Morelos,No recibe ingresos,135028,127842,7186,0,0,0
2014,Nacional,1 salario m¡nimo,916642,817899,98743,0,0,0
2014,Nacional,Menos de 1 s.m.,27002193,24193898,2808295,0,0,0
2014,Nacional,M s de 1 hasta 2 s.m.,738653,594948,143705,0,0,0
2014,Nacional,M s de 10 s.m.,33103070,14859009,18244061,0,0,0
2014,Nacional,M s de 2 hasta 3 s.m.,14896651,14374746,521905,0,0,0
2014,Nacional,M s de 3 hasta 5 s.m.,31553514,20055093,11498421,0,0,0
2014,Nacional,M s de 5 hasta 10 s.m.,5292961,3982533,1310428,0,0,0
2014,Nacional,No especificado,1464593,969770,494823,0,0,0
2014,Nacional,No recibe ingresos,8194785,7594848,599937,0,0,0
2014,Nayarit,1 salario m¡nimo,1890,1828,62,0,0,0
2014,Nayarit,Menos de 1 s.m.,406012,377433,28579,0,0,0
2014,Nayarit,M s de 1 hasta 2 s.m.,8310,7177,1133,0,0,0
2014,Nayarit,M s de 10 s.m.,370959,140936,230023,0,0,0
2014,Nayarit,M s de 2 hasta 3 s.m.,139238,135010,4228,0,0,0
2014,Nayarit,M s de 3 hasta 5 s.m.,159870,88017,71853,0,0,0
2014,Nayarit,M s de 5 hasta 10 s.m.,58651,43835,14816,0,0,0
2014,Nayarit,No especificado,12825,7344,5481,0,0,0
2014,Nayarit,No recibe ingresos,61953,57489,4464,0,0,0
2014,Nuevo Le¢n,1 salario m¡nimo,6857,5364,1493,0,0,0
2014,Nuevo Le¢n,Menos de 1 s.m.,181919,169154,12765,0,0,0
2014,Nuevo Le¢n,M s de 1 hasta 2 s.m.,47389,38802,8587,0,0,0
2014,Nuevo Le¢n,M s de 10 s.m.,1314349,630179,684170,0,0,0
2014,Nuevo Le¢n,M s de 2 hasta 3 s.m.,728082,683981,44101,0,0,0
2014,Nuevo Le¢n,M s de 3 hasta 5 s.m.,2081965,1542502,539463,0,0,0
2014,Nuevo Le¢n,M s de 5 hasta 10 s.m.,301803,219700,82103,0,0,0
2014,Nuevo Le¢n,No especificado,99581,62137,37444,0,0,0
2014,Nuevo Le¢n,No recibe ingresos,438142,391821,46321,0,0,0
2014,Oaxaca,1 salario m¡nimo,29053,27991,1062,0,0,0
2014,Oaxaca,Menos de 1 s.m.,2149218,1773054,376164,0,0,0
2014,Oaxaca,M s de 1 hasta 2 s.m.,16705,13489,3216,0,0,0
2014,Oaxaca,M s de 10 s.m.,931773,322871,608902,0,0,0
2014,Oaxaca,M s de 2 hasta 3 s.m.,429782,421540,8242,0,0,0
2014,Oaxaca,M s de 3 hasta 5 s.m.,732318,298708,433610,0,0,0
2014,Oaxaca,M s de 5 hasta 10 s.m.,77860,61143,16717,0,0,0
2014,Oaxaca,No especificado,16942,11377,5565,0,0,0
2014,Oaxaca,No recibe ingresos,211452,199806,11646,0,0,0
2014,Puebla,1 salario m¡nimo,16558,14798,1760,0,0,0
2014,Puebla,Menos de 1 s.m.,2548393,2069288,479105,0,0,0
2014,Puebla,M s de 1 hasta 2 s.m.,14510,11899,2611,0,0,0
2014,Puebla,M s de 10 s.m.,1706781,696268,1010513,0,0,0
2014,Puebla,M s de 2 hasta 3 s.m.,685618,666567,19051,0,0,0
2014,Puebla,M s de 3 hasta 5 s.m.,1442847,867289,575558,0,0,0
2014,Puebla,M s de 5 hasta 10 s.m.,227356,172390,54966,0,0,0
2014,Puebla,No especificado,48969,36840,12129,0,0,0
2014,Puebla,No recibe ingresos,364082,350597,13485,0,0,0
2014,Queretaro,1 salario m¡nimo,9383,8809,574,0,0,0
2014,Queretaro,Menos de 1 s.m.,199647,179665,19982,0,0,0
2014,Queretaro,M s de 1 hasta 2 s.m.,18227,13213,5014,0,0,0
2014,Queretaro,M s de 10 s.m.,412273,184146,228127,0,0,0
2014,Queretaro,M s de 2 hasta 3 s.m.,321769,312354,9415,0,0,0
2014,Queretaro,M s de 3 hasta 5 s.m.,620717,400553,220164,0,0,0
2014,Queretaro,M s de 5 hasta 10 s.m.,94757,70864,23893,0,0,0
2014,Queretaro,No especificado,32561,21409,11152,0,0,0
2014,Queretaro,No recibe ingresos,120067,112353,7714,0,0,0
2014,Quintana Roo,1 salario m¡nimo,4409,4409,0,0,0,0
2014,Quintana Roo,Menos de 1 s.m.,190849,180052,10797,0,0,0
2014,Quintana Roo,M s de 1 hasta 2 s.m.,12623,9279,3344,0,0,0
2014,Quintana Roo,M s de 10 s.m.,442323,187309,255014,0,0,0
2014,Quintana Roo,M s de 2 hasta 3 s.m.,240002,223145,16857,0,0,0
2014,Quintana Roo,M s de 3 hasta 5 s.m.,141075,92065,49010,0,0,0
2014,Quintana Roo,M s de 5 hasta 10 s.m.,75382,55748,19634,0,0,0
2014,Quintana Roo,No especificado,24203,16888,7315,0,0,0
2014,Quintana Roo,No recibe ingresos,152362,140726,11636,0,0,0
2014,San Luis Potos¡,1 salario m¡nimo,30728,27170,3558,0,0,0
2014,San Luis Potos¡,Menos de 1 s.m.,797696,739698,57998,0,0,0
2014,San Luis Potos¡,M s de 1 hasta 2 s.m.,18005,14468,3537,0,0,0
2014,San Luis Potos¡,M s de 10 s.m.,704099,301614,402485,0,0,0
2014,San Luis Potos¡,M s de 2 hasta 3 s.m.,301764,291700,10064,0,0,0
2014,San Luis Potos¡,M s de 3 hasta 5 s.m.,788129,514945,273184,0,0,0
2014,San Luis Potos¡,M s de 5 hasta 10 s.m.,100382,79210,21172,0,0,0
2014,San Luis Potos¡,No especificado,16892,8295,8597,0,0,0
2014,San Luis Potos¡,No recibe ingresos,129116,118473,10643,0,0,0
2014,Sinaloa,1 salario m¡nimo,13522,13522,0,0,0,0
2014,Sinaloa,Menos de 1 s.m.,965717,799724,165993,0,0,0
2014,Sinaloa,M s de 1 hasta 2 s.m.,45147,37891,7256,0,0,0
2014,Sinaloa,M s de 10 s.m.,846799,356929,489870,0,0,0
2014,Sinaloa,M s de 2 hasta 3 s.m.,360260,344190,16070,0,0,0
2014,Sinaloa,M s de 3 hasta 5 s.m.,492177,281738,210439,0,0,0
2014,Sinaloa,M s de 5 hasta 10 s.m.,186407,128786,57621,0,0,0
2014,Sinaloa,No especificado,39178,27616,11562,0,0,0
2014,Sinaloa,No recibe ingresos,149726,130295,19431,0,0,0
2014,Sonora,1 salario m¡nimo,88950,84226,4724,0,0,0
2014,Sonora,Menos de 1 s.m.,502861,433358,69503,0,0,0
2014,Sonora,M s de 1 hasta 2 s.m.,21684,17620,4064,0,0,0
2014,Sonora,M s de 10 s.m.,838754,361915,476839,0,0,0
2014,Sonora,M s de 2 hasta 3 s.m.,386050,362517,23533,0,0,0
2014,Sonora,M s de 3 hasta 5 s.m.,878236,496111,382125,0,0,0
2014,Sonora,M s de 5 hasta 10 s.m.,180730,133230,47500,0,0,0
2014,Sonora,No especificado,40150,28110,12040,0,0,0
2014,Sonora,No recibe ingresos,107066,98593,8473,0,0,0
2014,Tabasco,1 salario m¡nimo,147720,127515,20205,0,0,0
2014,Tabasco,Menos de 1 s.m.,546452,522617,23835,0,0,0
2014,Tabasco,M s de 1 hasta 2 s.m.,11313,6491,4822,0,0,0
2014,Tabasco,M s de 10 s.m.,657840,325415,332425,0,0,0
2014,Tabasco,M s de 2 hasta 3 s.m.,321038,306587,14451,0,0,0
2014,Tabasco,M s de 3 hasta 5 s.m.,236919,167861,69058,0,0,0
2014,Tabasco,M s de 5 hasta 10 s.m.,110222,84807,25415,0,0,0
2014,Tabasco,No especificado,15277,10570,4707,0,0,0
2014,Tabasco,No recibe ingresos,152600,149725,2875,0,0,0
2014,Tamaulipas,1 salario m¡nimo,53729,47323,6406,0,0,0
2014,Tamaulipas,Menos de 1 s.m.,385194,359610,25584,0,0,0
2014,Tamaulipas,M s de 1 hasta 2 s.m.,29369,25036,4333,0,0,0
2014,Tamaulipas,M s de 10 s.m.,991475,478857,512618,0,0,0
2014,Tamaulipas,M s de 2 hasta 3 s.m.,439527,415736,23791,0,0,0
2014,Tamaulipas,M s de 3 hasta 5 s.m.,1226148,739119,487029,0,0,0
2014,Tamaulipas,M s de 5 hasta 10 s.m.,129773,97862,31911,0,0,0
2014,Tamaulipas,No especificado,43984,30054,13930,0,0,0
2014,Tamaulipas,No recibe ingresos,310905,272083,38822,0,0,0
2014,Tlaxcala,1 salario m¡nimo,482,482,0,0,0,0
2014,Tlaxcala,Menos de 1 s.m.,276293,240697,35596,0,0,0
2014,Tlaxcala,M s de 1 hasta 2 s.m.,3539,2830,709,0,0,0
2014,Tlaxcala,M s de 10 s.m.,337141,151119,186022,0,0,0
2014,Tlaxcala,M s de 2 hasta 3 s.m.,187861,185534,2327,0,0,0
2014,Tlaxcala,M s de 3 hasta 5 s.m.,478175,273708,204467,0,0,0
2014,Tlaxcala,M s de 5 hasta 10 s.m.,35000,28349,6651,0,0,0
2014,Tlaxcala,No especificado,6644,4267,2377,0,0,0
2014,Tlaxcala,No recibe ingresos,60767,57334,3433,0,0,0
2014,Veracruz,1 salario m¡nimo,77717,65271,12446,0,0,0
2014,Veracruz,Menos de 1 s.m.,3220321,3021731,198590,0,0,0
2014,Veracruz,M s de 1 hasta 2 s.m.,49323,42346,6977,0,0,0
2014,Veracruz,M s de 10 s.m.,1853389,778287,1075102,0,0,0
2014,Veracruz,M s de 2 hasta 3 s.m.,1026850,1012434,14416,0,0,0
2014,Veracruz,M s de 3 hasta 5 s.m.,1135859,774908,360951,0,0,0
2014,Veracruz,M s de 5 hasta 10 s.m.,227223,176094,51129,0,0,0
2014,Veracruz,No especificado,73809,51536,22273,0,0,0
2014,Veracruz,No recibe ingresos,472973,448741,24232,0,0,0
2014,Yucat n,1 salario m¡nimo,6580,6580,0,0,0,0
2014,Yucat n,Menos de 1 s.m.,411726,391128,20598,0,0,0
2014,Yucat n,M s de 1 hasta 2 s.m.,15285,12887,2398,0,0,0
2014,Yucat n,M s de 10 s.m.,524737,233476,291261,0,0,0
2014,Yucat n,M s de 2 hasta 3 s.m.,366424,358060,8364,0,0,0
2014,Yucat n,M s de 3 hasta 5 s.m.,637684,328245,309439,0,0,0
2014,Yucat n,M s de 5 hasta 10 s.m.,126206,98841,27365,0,0,0
2014,Yucat n,No especificado,20495,13529,6966,0,0,0
2014,Yucat n,No recibe ingresos,139475,129706,9769,0,0,0
2014,Zacatecas,1 salario m¡nimo,47815,42938,4877,0,0,0
2014,Zacatecas,Menos de 1 s.m.,604017,540987,63030,0,0,0
2014,Zacatecas,M s de 1 hasta 2 s.m.,7029,5123,1906,0,0,0
2014,Zacatecas,M s de 10 s.m.,410358,174984,235374,0,0,0
2014,Zacatecas,M s de 2 hasta 3 s.m.,182504,179266,3238,0,0,0
2014,Zacatecas,M s de 3 hasta 5 s.m.,252358,151610,100748,0,0,0
2014,Zacatecas,M s de 5 hasta 10 s.m.,44101,37432,6669,0,0,0
2014,Zacatecas,No especificado,12281,7560,4721,0,0,0
2014,Zacatecas,No recibe ingresos,34586,32737,1849,0,0,0
2015,Aguascalientes,1 salario m¡nimo,6694,6694,0,0,0,0
2015,Aguascalientes,Menos de 1 s.m.,110970,104406,6564,0,0,0
2015,Aguascalientes,M s de 1 hasta 2 s.m.,7602,6025,1577,0,0,0
2015,Aguascalientes,M s de 10 s.m.,311623,156678,154945,0,0,0
2015,Aguascalientes,M s de 2 hasta 3 s.m.,153952,148085,5867,0,0,0
2015,Aguascalientes,M s de 3 hasta 5 s.m.,480651,335405,145246,0,0,0
2015,Aguascalientes,M s de 5 hasta 10 s.m.,68724,54667,14057,0,0,0
2015,Aguascalientes,No especificado,13982,9863,4119,0,0,0
2015,Aguascalientes,No recibe ingresos,76008,69235,6773,0,0,0
2015,Baja California,1 salario m¡nimo,4379,4070,309,0,0,0
2015,Baja California,Menos de 1 s.m.,317250,230995,86255,0,0,0
2015,Baja California,M s de 1 hasta 2 s.m.,40832,34792,6040,0,0,0
2015,Baja California,M s de 10 s.m.,986850,519393,467457,0,0,0
2015,Baja California,M s de 2 hasta 3 s.m.,371903,357545,14358,0,0,0
2015,Baja California,M s de 3 hasta 5 s.m.,1513315,920190,593125,0,0,0
2015,Baja California,M s de 5 hasta 10 s.m.,156587,113882,42705,0,0,0
2015,Baja California,No especificado,51842,33017,18825,0,0,0
2015,Baja California,No recibe ingresos,209876,192642,17234,0,0,0
2015,Baja California Sur,1 salario m¡nimo,8618,8050,568,0,0,0
2015,Baja California Sur,Menos de 1 s.m.,166217,123392,42825,0,0,0
2015,Baja California Sur,M s de 1 hasta 2 s.m.,10733,8652,2081,0,0,0
2015,Baja California Sur,M s de 10 s.m.,219276,102280,116996,0,0,0
2015,Baja California Sur,M s de 2 hasta 3 s.m.,143828,135368,8460,0,0,0
2015,Baja California Sur,M s de 3 hasta 5 s.m.,94587,64228,30359,0,0,0
2015,Baja California Sur,M s de 5 hasta 10 s.m.,41466,30241,11225,0,0,0
2015,Baja California Sur,No especificado,8408,5363,3045,0,0,0
2015,Baja California Sur,No recibe ingresos,59017,49476,9541,0,0,0
2015,Campeche,1 salario m¡nimo,36171,29427,6744,0,0,0
2015,Campeche,Menos de 1 s.m.,305272,289293,15979,0,0,0
2015,Campeche,M s de 1 hasta 2 s.m.,6634,4782,1852,0,0,0
2015,Campeche,M s de 10 s.m.,236187,98677,137510,0,0,0
2015,Campeche,M s de 2 hasta 3 s.m.,163728,154913,8815,0,0,0
2015,Campeche,M s de 3 hasta 5 s.m.,138068,72187,65881,0,0,0
2015,Campeche,M s de 5 hasta 10 s.m.,25762,21392,4370,0,0,0
2015,Campeche,No especificado,9556,6892,2664,0,0,0
2015,Campeche,No recibe ingresos,54238,49613,4625,0,0,0
2015,Chiapas,1 salario m¡nimo,24035,20424,3611,0,0,0
2015,Chiapas,Menos de 1 s.m.,2882382,2774301,108081,0,0,0
2015,Chiapas,M s de 1 hasta 2 s.m.,14046,10858,3188,0,0,0
2015,Chiapas,M s de 10 s.m.,1069545,396617,672928,0,0,0
2015,Chiapas,M s de 2 hasta 3 s.m.,531613,524566,7047,0,0,0
2015,Chiapas,M s de 3 hasta 5 s.m.,542991,279306,263685,0,0,0
2015,Chiapas,M s de 5 hasta 10 s.m.,141101,118541,22560,0,0,0
2015,Chiapas,No especificado,20663,13279,7384,0,0,0
2015,Chiapas,No recibe ingresos,271601,263049,8552,0,0,0
2015,Chihuahua,1 salario m¡nimo,67625,60672,6953,0,0,0
2015,Chihuahua,Menos de 1 s.m.,551558,512847,38711,0,0,0
2015,Chihuahua,M s de 1 hasta 2 s.m.,27464,21930,5534,0,0,0
2015,Chihuahua,M s de 10 s.m.,880499,459396,421103,0,0,0
2015,Chihuahua,M s de 2 hasta 3 s.m.,490381,471836,18545,0,0,0
2015,Chihuahua,M s de 3 hasta 5 s.m.,1794982,1139775,655207,0,0,0
2015,Chihuahua,M s de 5 hasta 10 s.m.,176271,132215,44056,0,0,0
2015,Chihuahua,No especificado,43185,32088,11097,0,0,0
2015,Chihuahua,No recibe ingresos,188119,165752,22367,0,0,0
2015,Ciudad de Mxico,1 salario m¡nimo,2339,2339,0,0,0,0
2015,Ciudad de Mxico,Menos de 1 s.m.,141821,111857,29964,0,0,0
2015,Ciudad de Mxico,M s de 1 hasta 2 s.m.,53956,41715,12241,0,0,0
2015,Ciudad de Mxico,M s de 10 s.m.,2909816,1475316,1434500,0,0,0
2015,Ciudad de Mxico,M s de 2 hasta 3 s.m.,859898,784083,75815,0,0,0
2015,Ciudad de Mxico,M s de 3 hasta 5 s.m.,1654702,1090992,563710,0,0,0
2015,Ciudad de Mxico,M s de 5 hasta 10 s.m.,519511,354387,165124,0,0,0
2015,Ciudad de Mxico,No especificado,345610,227443,118167,0,0,0
2015,Ciudad de Mxico,No recibe ingresos,950560,854936,95624,0,0,0
2015,Coahuila,1 salario m¡nimo,50729,47439,3290,0,0,0
2015,Coahuila,Menos de 1 s.m.,251565,227798,23767,0,0,0
2015,Coahuila,M s de 1 hasta 2 s.m.,21403,16499,4904,0,0,0
2015,Coahuila,M s de 10 s.m.,715871,321933,393938,0,0,0
2015,Coahuila,M s de 2 hasta 3 s.m.,400300,389308,10992,0,0,0
2015,Coahuila,M s de 3 hasta 5 s.m.,1457929,999979,457950,0,0,0
2015,Coahuila,M s de 5 hasta 10 s.m.,138653,103016,35637,0,0,0
2015,Coahuila,No especificado,39877,23629,16248,0,0,0
2015,Coahuila,No recibe ingresos,187395,171459,15936,0,0,0
2015,Colima,1 salario m¡nimo,6382,5924,458,0,0,0
2015,Colima,Menos de 1 s.m.,150329,127896,22433,0,0,0
2015,Colima,M s de 1 hasta 2 s.m.,13907,12270,1637,0,0,0
2015,Colima,M s de 10 s.m.,193200,73577,119623,0,0,0
2015,Colima,M s de 2 hasta 3 s.m.,121391,117382,4009,0,0,0
2015,Colima,M s de 3 hasta 5 s.m.,112574,67907,44667,0,0,0
2015,Colima,M s de 5 hasta 10 s.m.,43555,30772,12783,0,0,0
2015,Colima,No especificado,9430,5697,3733,0,0,0
2015,Colima,No recibe ingresos,87126,71274,15852,0,0,0
2015,Durango,1 salario m¡nimo,62315,56728,5587,0,0,0
2015,Durango,Menos de 1 s.m.,524595,477680,46915,0,0,0
2015,Durango,M s de 1 hasta 2 s.m.,5793,4747,1046,0,0,0
2015,Durango,M s de 10 s.m.,468529,181013,287516,0,0,0
2015,Durango,M s de 2 hasta 3 s.m.,219383,210972,8411,0,0,0
2015,Durango,M s de 3 hasta 5 s.m.,440412,286128,154284,0,0,0
2015,Durango,M s de 5 hasta 10 s.m.,62956,51098,11858,0,0,0
2015,Durango,No especificado,15231,9328,5903,0,0,0
2015,Durango,No recibe ingresos,108809,102818,5991,0,0,0
2015,Estado de Mxico,1 salario m¡nimo,26659,25030,1629,0,0,0
2015,Estado de Mxico,Menos de 1 s.m.,1327890,1199604,128286,0,0,0
2015,Estado de Mxico,M s de 1 hasta 2 s.m.,91670,69448,22222,0,0,0
2015,Estado de Mxico,M s de 10 s.m.,5505833,2678041,2827792,0,0,0
2015,Estado de Mxico,M s de 2 hasta 3 s.m.,2398037,2313194,84843,0,0,0
2015,Estado de Mxico,M s de 3 hasta 5 s.m.,4993562,3288320,1705242,0,0,0
2015,Estado de Mxico,M s de 5 hasta 10 s.m.,746274,563836,182438,0,0,0
2015,Estado de Mxico,No especificado,231963,186899,45064,0,0,0
2015,Estado de Mxico,No recibe ingresos,1812400,1708669,103731,0,0,0
2015,Guanajuato,1 salario m¡nimo,8068,8068,0,0,0,0
2015,Guanajuato,Menos de 1 s.m.,1015906,881420,134486,0,0,0
2015,Guanajuato,M s de 1 hasta 2 s.m.,26513,22498,4015,0,0,0
2015,Guanajuato,M s de 10 s.m.,1619797,650391,969406,0,0,0
2015,Guanajuato,M s de 2 hasta 3 s.m.,775730,756624,19106,0,0,0
2015,Guanajuato,M s de 3 hasta 5 s.m.,2309302,1549280,760022,0,0,0
2015,Guanajuato,M s de 5 hasta 10 s.m.,367432,277349,90083,0,0,0
2015,Guanajuato,No especificado,39538,27401,12137,0,0,0
2015,Guanajuato,No recibe ingresos,255738,238806,16932,0,0,0
2015,Guerrero,1 salario m¡nimo,5551,4246,1305,0,0,0
2015,Guerrero,Menos de 1 s.m.,1698885,1458598,240287,0,0,0
2015,Guerrero,M s de 1 hasta 2 s.m.,20782,12960,7822,0,0,0
2015,Guerrero,M s de 10 s.m.,811418,297185,514233,0,0,0
2015,Guerrero,M s de 2 hasta 3 s.m.,401172,398021,3151,0,0,0
2015,Guerrero,M s de 3 hasta 5 s.m.,467849,190349,277500,0,0,0
2015,Guerrero,M s de 5 hasta 10 s.m.,98879,79896,18983,0,0,0
2015,Guerrero,No especificado,14912,7037,7875,0,0,0
2015,Guerrero,No recibe ingresos,208485,199009,9476,0,0,0
2015,Hidalgo,1 salario m¡nimo,25432,21548,3884,0,0,0
2015,Hidalgo,Menos de 1 s.m.,813258,710470,102788,0,0,0
2015,Hidalgo,M s de 1 hasta 2 s.m.,24464,19774,4690,0,0,0
2015,Hidalgo,M s de 10 s.m.,815349,348317,467032,0,0,0
2015,Hidalgo,M s de 2 hasta 3 s.m.,473290,455146,18144,0,0,0
2015,Hidalgo,M s de 3 hasta 5 s.m.,734148,415742,318406,0,0,0
2015,Hidalgo,M s de 5 hasta 10 s.m.,119175,94048,25127,0,0,0
2015,Hidalgo,No especificado,21056,12682,8374,0,0,0
2015,Hidalgo,No recibe ingresos,158622,154764,3858,0,0,0
2015,Jalisco,1 salario m¡nimo,7151,5613,1538,0,0,0
2015,Jalisco,Menos de 1 s.m.,1287953,1116796,171157,0,0,0
2015,Jalisco,M s de 1 hasta 2 s.m.,40360,25144,15216,0,0,0
2015,Jalisco,M s de 10 s.m.,2322496,1018763,1303733,0,0,0
2015,Jalisco,M s de 2 hasta 3 s.m.,1072718,1037370,35348,0,0,0
2015,Jalisco,M s de 3 hasta 5 s.m.,2647350,1675556,971794,0,0,0
2015,Jalisco,M s de 5 hasta 10 s.m.,520455,382957,137498,0,0,0
2015,Jalisco,No especificado,107348,79001,28347,0,0,0
2015,Jalisco,No recibe ingresos,399672,355349,44323,0,0,0
2015,Michoac n,1 salario m¡nimo,13959,13959,0,0,0,0
2015,Michoac n,Menos de 1 s.m.,1822695,1658702,163993,0,0,0
2015,Michoac n,M s de 1 hasta 2 s.m.,36514,34236,2278,0,0,0
2015,Michoac n,M s de 10 s.m.,1361626,540084,821542,0,0,0
2015,Michoac n,M s de 2 hasta 3 s.m.,492225,483053,9172,0,0,0
2015,Michoac n,M s de 3 hasta 5 s.m.,952117,586989,365128,0,0,0
2015,Michoac n,M s de 5 hasta 10 s.m.,242798,173491,69307,0,0,0
2015,Michoac n,No especificado,35637,24152,11485,0,0,0
2015,Michoac n,No recibe ingresos,207304,200869,6435,0,0,0
2015,Morelos,1 salario m¡nimo,3887,3437,450,0,0,0
2015,Morelos,Menos de 1 s.m.,312373,293958,18415,0,0,0
2015,Morelos,M s de 1 hasta 2 s.m.,9232,7317,1915,0,0,0
2015,Morelos,M s de 10 s.m.,566400,227523,338877,0,0,0
2015,Morelos,M s de 2 hasta 3 s.m.,302127,297488,4639,0,0,0
2015,Morelos,M s de 3 hasta 5 s.m.,369602,242173,127429,0,0,0
2015,Morelos,M s de 5 hasta 10 s.m.,65018,50604,14414,0,0,0
2015,Morelos,No especificado,28619,19717,8902,0,0,0
2015,Morelos,No recibe ingresos,138112,128964,9148,0,0,0
2015,Nacional,1 salario m¡nimo,918202,815195,103007,0,0,0
2015,Nacional,Menos de 1 s.m.,26975779,24109516,2866263,0,0,0
2015,Nacional,M s de 1 hasta 2 s.m.,782447,622847,159600,0,0,0
2015,Nacional,M s de 10 s.m.,33292993,14726507,18566486,0,0,0
2015,Nacional,M s de 2 hasta 3 s.m.,15850477,15299859,550618,0,0,0
2015,Nacional,M s de 3 hasta 5 s.m.,32463648,20531393,11932255,0,0,0
2015,Nacional,M s de 5 hasta 10 s.m.,5589346,4186985,1402361,0,0,0
2015,Nacional,No especificado,1503863,1035920,467943,0,0,0
2015,Nacional,No recibe ingresos,8461377,7813683,647694,0,0,0
2015,Nayarit,1 salario m¡nimo,3127,3127,0,0,0,0
2015,Nayarit,Menos de 1 s.m.,445144,412477,32667,0,0,0
2015,Nayarit,M s de 1 hasta 2 s.m.,9884,8045,1839,0,0,0
2015,Nayarit,M s de 10 s.m.,361125,133479,227646,0,0,0
2015,Nayarit,M s de 2 hasta 3 s.m.,152426,146175,6251,0,0,0
2015,Nayarit,M s de 3 hasta 5 s.m.,172529,91139,81390,0,0,0
2015,Nayarit,M s de 5 hasta 10 s.m.,53473,38570,14903,0,0,0
2015,Nayarit,No especificado,12579,7306,5273,0,0,0
2015,Nayarit,No recibe ingresos,69354,63412,5942,0,0,0
2015,Nuevo Le¢n,1 salario m¡nimo,5676,5297,379,0,0,0
2015,Nuevo Le¢n,Menos de 1 s.m.,152134,140689,11445,0,0,0
2015,Nuevo Le¢n,M s de 1 hasta 2 s.m.,49454,42822,6632,0,0,0
2015,Nuevo Le¢n,M s de 10 s.m.,1304764,628238,676526,0,0,0
2015,Nuevo Le¢n,M s de 2 hasta 3 s.m.,769589,728118,41471,0,0,0
2015,Nuevo Le¢n,M s de 3 hasta 5 s.m.,2242722,1627116,615606,0,0,0
2015,Nuevo Le¢n,M s de 5 hasta 10 s.m.,305476,222834,82642,0,0,0
2015,Nuevo Le¢n,No especificado,88529,62948,25581,0,0,0
2015,Nuevo Le¢n,No recibe ingresos,458764,410872,47892,0,0,0
2015,Oaxaca,1 salario m¡nimo,42221,35942,6279,0,0,0
2015,Oaxaca,Menos de 1 s.m.,2103356,1766613,336743,0,0,0
2015,Oaxaca,M s de 1 hasta 2 s.m.,12248,9373,2875,0,0,0
2015,Oaxaca,M s de 10 s.m.,879944,287511,592433,0,0,0
2015,Oaxaca,M s de 2 hasta 3 s.m.,431429,426163,5266,0,0,0
2015,Oaxaca,M s de 3 hasta 5 s.m.,727281,330111,397170,0,0,0
2015,Oaxaca,M s de 5 hasta 10 s.m.,80572,64528,16044,0,0,0
2015,Oaxaca,No especificado,20934,14834,6100,0,0,0
2015,Oaxaca,No recibe ingresos,220245,205861,14384,0,0,0
2015,Puebla,1 salario m¡nimo,12993,11852,1141,0,0,0
2015,Puebla,Menos de 1 s.m.,2554044,2083592,470452,0,0,0
2015,Puebla,M s de 1 hasta 2 s.m.,18724,15354,3370,0,0,0
2015,Puebla,M s de 10 s.m.,1687692,677755,1009937,0,0,0
2015,Puebla,M s de 2 hasta 3 s.m.,698971,683427,15544,0,0,0
2015,Puebla,M s de 3 hasta 5 s.m.,1469168,882526,586642,0,0,0
2015,Puebla,M s de 5 hasta 10 s.m.,284461,218348,66113,0,0,0
2015,Puebla,No especificado,57740,40245,17495,0,0,0
2015,Puebla,No recibe ingresos,359769,347940,11829,0,0,0
2015,Queretaro,1 salario m¡nimo,6310,5451,859,0,0,0
2015,Queretaro,Menos de 1 s.m.,192811,175769,17042,0,0,0
2015,Queretaro,M s de 1 hasta 2 s.m.,8318,7253,1065,0,0,0
2015,Queretaro,M s de 10 s.m.,445828,195793,250035,0,0,0
2015,Queretaro,M s de 2 hasta 3 s.m.,355909,340831,15078,0,0,0
2015,Queretaro,M s de 3 hasta 5 s.m.,666617,440493,226124,0,0,0
2015,Queretaro,M s de 5 hasta 10 s.m.,108015,83110,24905,0,0,0
2015,Queretaro,No especificado,25907,17489,8418,0,0,0
2015,Queretaro,No recibe ingresos,118105,107463,10642,0,0,0
2015,Quintana Roo,1 salario m¡nimo,1566,1566,0,0,0,0
2015,Quintana Roo,Menos de 1 s.m.,193777,183045,10732,0,0,0
2015,Quintana Roo,M s de 1 hasta 2 s.m.,15744,11922,3822,0,0,0
2015,Quintana Roo,M s de 10 s.m.,447645,194709,252936,0,0,0
2015,Quintana Roo,M s de 2 hasta 3 s.m.,249921,234765,15156,0,0,0
2015,Quintana Roo,M s de 3 hasta 5 s.m.,146067,93724,52343,0,0,0
2015,Quintana Roo,M s de 5 hasta 10 s.m.,79135,58643,20492,0,0,0
2015,Quintana Roo,No especificado,21920,16021,5899,0,0,0
2015,Quintana Roo,No recibe ingresos,158498,145484,13014,0,0,0
2015,San Luis Potos¡,1 salario m¡nimo,27824,24942,2882,0,0,0
2015,San Luis Potos¡,Menos de 1 s.m.,822801,757274,65527,0,0,0
2015,San Luis Potos¡,M s de 1 hasta 2 s.m.,18565,12444,6121,0,0,0
2015,San Luis Potos¡,M s de 10 s.m.,710907,304926,405981,0,0,0
2015,San Luis Potos¡,M s de 2 hasta 3 s.m.,327041,317535,9506,0,0,0
2015,San Luis Potos¡,M s de 3 hasta 5 s.m.,791015,509668,281347,0,0,0
2015,San Luis Potos¡,M s de 5 hasta 10 s.m.,107603,85724,21879,0,0,0
2015,San Luis Potos¡,No especificado,18775,10053,8722,0,0,0
2015,San Luis Potos¡,No recibe ingresos,132072,121285,10787,0,0,0
2015,Sinaloa,1 salario m¡nimo,16465,15881,584,0,0,0
2015,Sinaloa,Menos de 1 s.m.,879528,750380,129148,0,0,0
2015,Sinaloa,M s de 1 hasta 2 s.m.,44130,38357,5773,0,0,0
2015,Sinaloa,M s de 10 s.m.,879722,371829,507893,0,0,0
2015,Sinaloa,M s de 2 hasta 3 s.m.,402365,388497,13868,0,0,0
2015,Sinaloa,M s de 3 hasta 5 s.m.,521232,311456,209776,0,0,0
2015,Sinaloa,M s de 5 hasta 10 s.m.,179867,131264,48603,0,0,0
2015,Sinaloa,No especificado,36628,21904,14724,0,0,0
2015,Sinaloa,No recibe ingresos,166255,151445,14810,0,0,0
2015,Sonora,1 salario m¡nimo,108559,103261,5298,0,0,0
2015,Sonora,Menos de 1 s.m.,542711,450953,91758,0,0,0
2015,Sonora,M s de 1 hasta 2 s.m.,34812,29157,5655,0,0,0
2015,Sonora,M s de 10 s.m.,835752,325522,510230,0,0,0
2015,Sonora,M s de 2 hasta 3 s.m.,433590,409101,24489,0,0,0
2015,Sonora,M s de 3 hasta 5 s.m.,917231,501966,415265,0,0,0
2015,Sonora,M s de 5 hasta 10 s.m.,167893,131793,36100,0,0,0
2015,Sonora,No especificado,35418,24911,10507,0,0,0
2015,Sonora,No recibe ingresos,142868,126457,16411,0,0,0
2015,Tabasco,1 salario m¡nimo,120606,102760,17846,0,0,0
2015,Tabasco,Menos de 1 s.m.,455789,432367,23422,0,0,0
2015,Tabasco,M s de 1 hasta 2 s.m.,15686,9668,6018,0,0,0
2015,Tabasco,M s de 10 s.m.,633858,300726,333132,0,0,0
2015,Tabasco,M s de 2 hasta 3 s.m.,354037,341887,12150,0,0,0
2015,Tabasco,M s de 3 hasta 5 s.m.,247680,178038,69642,0,0,0
2015,Tabasco,M s de 5 hasta 10 s.m.,124740,91376,33364,0,0,0
2015,Tabasco,No especificado,18051,11635,6416,0,0,0
2015,Tabasco,No recibe ingresos,164772,160376,4396,0,0,0
2015,Tamaulipas,1 salario m¡nimo,66801,47410,19391,0,0,0
2015,Tamaulipas,Menos de 1 s.m.,373825,352035,21790,0,0,0
2015,Tamaulipas,M s de 1 hasta 2 s.m.,22955,20391,2564,0,0,0
2015,Tamaulipas,M s de 10 s.m.,976305,447950,528355,0,0,0
2015,Tamaulipas,M s de 2 hasta 3 s.m.,459413,440811,18602,0,0,0
2015,Tamaulipas,M s de 3 hasta 5 s.m.,1254031,770859,483172,0,0,0
2015,Tamaulipas,M s de 5 hasta 10 s.m.,124393,87223,37170,0,0,0
2015,Tamaulipas,No especificado,43878,29418,14460,0,0,0
2015,Tamaulipas,No recibe ingresos,346814,295719,51095,0,0,0
2015,Tlaxcala,1 salario m¡nimo,926,926,0,0,0,0
2015,Tlaxcala,Menos de 1 s.m.,277009,239282,37727,0,0,0
2015,Tlaxcala,M s de 1 hasta 2 s.m.,4279,3832,447,0,0,0
2015,Tlaxcala,M s de 10 s.m.,340536,153046,187490,0,0,0
2015,Tlaxcala,M s de 2 hasta 3 s.m.,210176,206700,3476,0,0,0
2015,Tlaxcala,M s de 3 hasta 5 s.m.,520122,297587,222535,0,0,0
2015,Tlaxcala,M s de 5 hasta 10 s.m.,36595,29637,6958,0,0,0
2015,Tlaxcala,No especificado,6685,4836,1849,0,0,0
2015,Tlaxcala,No recibe ingresos,59776,56345,3431,0,0,0
2015,Veracruz,1 salario m¡nimo,92456,82622,9834,0,0,0
2015,Veracruz,Menos de 1 s.m.,3249727,3113753,135974,0,0,0
2015,Veracruz,M s de 1 hasta 2 s.m.,53303,44375,8928,0,0,0
2015,Veracruz,M s de 10 s.m.,1864975,746461,1118514,0,0,0
2015,Veracruz,M s de 2 hasta 3 s.m.,1042443,1023514,18929,0,0,0
2015,Veracruz,M s de 3 hasta 5 s.m.,1158403,789413,368990,0,0,0
2015,Veracruz,M s de 5 hasta 10 s.m.,228620,177120,51500,0,0,0
2015,Veracruz,No especificado,46697,27918,18779,0,0,0
2015,Veracruz,No recibe ingresos,509268,475865,33403,0,0,0
2015,Yucat n,1 salario m¡nimo,8240,8062,178,0,0,0
2015,Yucat n,Menos de 1 s.m.,419937,400411,19526,0,0,0
2015,Yucat n,M s de 1 hasta 2 s.m.,17758,12341,5417,0,0,0
2015,Yucat n,M s de 10 s.m.,527372,250932,276440,0,0,0
2015,Yucat n,M s de 2 hasta 3 s.m.,382467,370125,12342,0,0,0
2015,Yucat n,M s de 3 hasta 5 s.m.,676543,345770,330773,0,0,0
2015,Yucat n,M s de 5 hasta 10 s.m.,133449,99817,33632,0,0,0
2015,Yucat n,No especificado,23616,16152,7464,0,0,0
2015,Yucat n,No recibe ingresos,136973,129319,7654,0,0,0
2015,Zacatecas,1 salario m¡nimo,44438,42428,2010,0,0,0
2015,Zacatecas,Menos de 1 s.m.,632267,550863,81404,0,0,0
2015,Zacatecas,M s de 1 hasta 2 s.m.,4682,3866,816,0,0,0
2015,Zacatecas,M s de 10 s.m.,402253,162446,239807,0,0,0
2015,Zacatecas,M s de 2 hasta 3 s.m.,209024,207256,1768,0,0,0
2015,Zacatecas,M s de 3 hasta 5 s.m.,248866,157021,91845,0,0,0
2015,Zacatecas,M s de 5 hasta 10 s.m.,40437,34606,5831,0,0,0
2015,Zacatecas,No especificado,9649,6762,2887,0,0,0
2015,Zacatecas,No recibe ingresos,44762,39156,5606,0,0,0
2016,Aguascalientes,1 salario m¡nimo,7594,6951,643,0,0,0
2016,Aguascalientes,Menos de 1 s.m.,106923,97926,8997,0,0,0
2016,Aguascalientes,M s de 1 hasta 2 s.m.,7715,6141,1574,0,0,0
2016,Aguascalientes,M s de 10 s.m.,344123,158293,185830,0,0,0
2016,Aguascalientes,M s de 2 hasta 3 s.m.,173717,167587,6130,0,0,0
2016,Aguascalientes,M s de 3 hasta 5 s.m.,506104,346773,159331,0,0,0
2016,Aguascalientes,M s de 5 hasta 10 s.m.,66638,52723,13915,0,0,0
2016,Aguascalientes,No especificado,17643,12622,5021,0,0,0
2016,Aguascalientes,No recibe ingresos,82650,74718,7932,0,0,0
2016,Baja California,1 salario m¡nimo,4456,4124,332,0,0,0
2016,Baja California,Menos de 1 s.m.,363935,259486,104449,0,0,0
2016,Baja California,M s de 1 hasta 2 s.m.,38252,28749,9503,0,0,0
2016,Baja California,M s de 10 s.m.,985205,506161,479044,0,0,0
2016,Baja California,M s de 2 hasta 3 s.m.,405234,391411,13823,0,0,0
2016,Baja California,M s de 3 hasta 5 s.m.,1583293,967541,615752,0,0,0
2016,Baja California,M s de 5 hasta 10 s.m.,157810,118592,39218,0,0,0
2016,Baja California,No especificado,47898,32490,15408,0,0,0
2016,Baja California,No recibe ingresos,236388,209022,27366,0,0,0
2016,Baja California Sur,1 salario m¡nimo,11468,10709,759,0,0,0
2016,Baja California Sur,Menos de 1 s.m.,136711,104655,32056,0,0,0
2016,Baja California Sur,M s de 1 hasta 2 s.m.,17501,13624,3877,0,0,0
2016,Baja California Sur,M s de 10 s.m.,209807,93137,116670,0,0,0
2016,Baja California Sur,M s de 2 hasta 3 s.m.,170308,161695,8613,0,0,0
2016,Baja California Sur,M s de 3 hasta 5 s.m.,104886,64965,39921,0,0,0
2016,Baja California Sur,M s de 5 hasta 10 s.m.,44716,33689,11027,0,0,0
2016,Baja California Sur,No especificado,11710,7652,4058,0,0,0
2016,Baja California Sur,No recibe ingresos,58040,50200,7840,0,0,0
2016,Campeche,1 salario m¡nimo,31761,26103,5658,0,0,0
2016,Campeche,Menos de 1 s.m.,291686,278822,12864,0,0,0
2016,Campeche,M s de 1 hasta 2 s.m.,4960,4278,682,0,0,0
2016,Campeche,M s de 10 s.m.,241689,98918,142771,0,0,0
2016,Campeche,M s de 2 hasta 3 s.m.,166617,159124,7493,0,0,0
2016,Campeche,M s de 3 hasta 5 s.m.,126246,68961,57285,0,0,0
2016,Campeche,M s de 5 hasta 10 s.m.,31081,25647,5434,0,0,0
2016,Campeche,No especificado,8865,5446,3419,0,0,0
2016,Campeche,No recibe ingresos,58543,56690,1853,0,0,0
2016,Chiapas,1 salario m¡nimo,34108,31169,2939,0,0,0
2016,Chiapas,Menos de 1 s.m.,2872863,2791834,81029,0,0,0
2016,Chiapas,M s de 1 hasta 2 s.m.,14486,11155,3331,0,0,0
2016,Chiapas,M s de 10 s.m.,1146769,425037,721732,0,0,0
2016,Chiapas,M s de 2 hasta 3 s.m.,584745,574257,10488,0,0,0
2016,Chiapas,M s de 3 hasta 5 s.m.,596470,290557,305913,0,0,0
2016,Chiapas,M s de 5 hasta 10 s.m.,157928,131261,26667,0,0,0
2016,Chiapas,No especificado,20242,13822,6420,0,0,0
2016,Chiapas,No recibe ingresos,266899,256299,10600,0,0,0
2016,Chihuahua,1 salario m¡nimo,50084,44926,5158,0,0,0
2016,Chihuahua,Menos de 1 s.m.,588040,543447,44593,0,0,0
2016,Chihuahua,M s de 1 hasta 2 s.m.,26569,20641,5928,0,0,0
2016,Chihuahua,M s de 10 s.m.,894487,439345,455142,0,0,0
2016,Chihuahua,M s de 2 hasta 3 s.m.,480578,464995,15583,0,0,0
2016,Chihuahua,M s de 3 hasta 5 s.m.,1874162,1136739,737423,0,0,0
2016,Chihuahua,M s de 5 hasta 10 s.m.,213156,155995,57161,0,0,0
2016,Chihuahua,No especificado,26040,17303,8737,0,0,0
2016,Chihuahua,No recibe ingresos,184459,165318,19141,0,0,0
2016,Ciudad de Mxico,1 salario m¡nimo,3806,2171,1635,0,0,0
2016,Ciudad de Mxico,Menos de 1 s.m.,112086,92998,19088,0,0,0
2016,Ciudad de Mxico,M s de 1 hasta 2 s.m.,38078,33958,4120,0,0,0
2016,Ciudad de Mxico,M s de 10 s.m.,2748364,1348208,1400156,0,0,0
2016,Ciudad de Mxico,M s de 2 hasta 3 s.m.,992730,914934,77796,0,0,0
2016,Ciudad de Mxico,M s de 3 hasta 5 s.m.,1859134,1209937,649197,0,0,0
2016,Ciudad de Mxico,M s de 5 hasta 10 s.m.,481058,344718,136340,0,0,0
2016,Ciudad de Mxico,No especificado,399190,264274,134916,0,0,0
2016,Ciudad de Mxico,No recibe ingresos,902559,799098,103461,0,0,0
2016,Coahuila,1 salario m¡nimo,23999,21164,2835,0,0,0
2016,Coahuila,Menos de 1 s.m.,265020,238356,26664,0,0,0
2016,Coahuila,M s de 1 hasta 2 s.m.,18875,17197,1678,0,0,0
2016,Coahuila,M s de 10 s.m.,735394,324708,410686,0,0,0
2016,Coahuila,M s de 2 hasta 3 s.m.,415182,399373,15809,0,0,0
2016,Coahuila,M s de 3 hasta 5 s.m.,1464268,1054848,409420,0,0,0
2016,Coahuila,M s de 5 hasta 10 s.m.,146115,115523,30592,0,0,0
2016,Coahuila,No especificado,39059,24011,15048,0,0,0
2016,Coahuila,No recibe ingresos,198920,183554,15366,0,0,0
2016,Colima,1 salario m¡nimo,7044,6168,876,0,0,0
2016,Colima,Menos de 1 s.m.,173893,146781,27112,0,0,0
2016,Colima,M s de 1 hasta 2 s.m.,13382,11289,2093,0,0,0
2016,Colima,M s de 10 s.m.,211216,81034,130182,0,0,0
2016,Colima,M s de 2 hasta 3 s.m.,122050,117772,4278,0,0,0
2016,Colima,M s de 3 hasta 5 s.m.,109617,65334,44283,0,0,0
2016,Colima,M s de 5 hasta 10 s.m.,38475,29820,8655,0,0,0
2016,Colima,No especificado,9816,5957,3859,0,0,0
2016,Colima,No recibe ingresos,93983,78238,15745,0,0,0
2016,Durango,1 salario m¡nimo,69378,61638,7740,0,0,0
2016,Durango,Menos de 1 s.m.,405507,370543,34964,0,0,0
2016,Durango,M s de 1 hasta 2 s.m.,6303,4436,1867,0,0,0
2016,Durango,M s de 10 s.m.,525531,198853,326678,0,0,0
2016,Durango,M s de 2 hasta 3 s.m.,263441,254179,9262,0,0,0
2016,Durango,M s de 3 hasta 5 s.m.,485372,341546,143826,0,0,0
2016,Durango,M s de 5 hasta 10 s.m.,72519,56242,16277,0,0,0
2016,Durango,No especificado,16121,10850,5271,0,0,0
2016,Durango,No recibe ingresos,112336,104056,8280,0,0,0
2016,Estado de Mxico,1 salario m¡nimo,33948,32649,1299,0,0,0
2016,Estado de Mxico,Menos de 1 s.m.,1304891,1170298,134593,0,0,0
2016,Estado de Mxico,M s de 1 hasta 2 s.m.,120951,94134,26817,0,0,0
2016,Estado de Mxico,M s de 10 s.m.,5267657,2536240,2731417,0,0,0
2016,Estado de Mxico,M s de 2 hasta 3 s.m.,2488998,2413973,75025,0,0,0
2016,Estado de Mxico,M s de 3 hasta 5 s.m.,4943630,3292440,1651190,0,0,0
2016,Estado de Mxico,M s de 5 hasta 10 s.m.,809401,564511,244890,0,0,0
2016,Estado de Mxico,No especificado,273899,209239,64660,0,0,0
2016,Estado de Mxico,No recibe ingresos,1863914,1737556,126358,0,0,0
2016,Guanajuato,1 salario m¡nimo,35041,32604,2437,0,0,0
2016,Guanajuato,Menos de 1 s.m.,976394,810151,166243,0,0,0
2016,Guanajuato,M s de 1 hasta 2 s.m.,37627,26308,11319,0,0,0
2016,Guanajuato,M s de 10 s.m.,1613577,648295,965282,0,0,0
2016,Guanajuato,M s de 2 hasta 3 s.m.,906268,885927,20341,0,0,0
2016,Guanajuato,M s de 3 hasta 5 s.m.,2350116,1545560,804556,0,0,0
2016,Guanajuato,M s de 5 hasta 10 s.m.,435569,313052,122517,0,0,0
2016,Guanajuato,No especificado,38806,23276,15530,0,0,0
2016,Guanajuato,No recibe ingresos,242377,215425,26952,0,0,0
2016,Guerrero,1 salario m¡nimo,16518,6510,10008,0,0,0
2016,Guerrero,Menos de 1 s.m.,1710448,1486508,223940,0,0,0
2016,Guerrero,M s de 1 hasta 2 s.m.,13752,11058,2694,0,0,0
2016,Guerrero,M s de 10 s.m.,809191,293810,515381,0,0,0
2016,Guerrero,M s de 2 hasta 3 s.m.,370804,364463,6341,0,0,0
2016,Guerrero,M s de 3 hasta 5 s.m.,562861,266719,296142,0,0,0
2016,Guerrero,M s de 5 hasta 10 s.m.,89143,73196,15947,0,0,0
2016,Guerrero,No especificado,19736,12076,7660,0,0,0
2016,Guerrero,No recibe ingresos,202945,194081,8864,0,0,0
2016,Hidalgo,1 salario m¡nimo,12125,12125,0,0,0,0
2016,Hidalgo,Menos de 1 s.m.,850466,735240,115226,0,0,0
2016,Hidalgo,M s de 1 hasta 2 s.m.,19198,14033,5165,0,0,0
2016,Hidalgo,M s de 10 s.m.,765988,330112,435876,0,0,0
2016,Hidalgo,M s de 2 hasta 3 s.m.,485241,471996,13245,0,0,0
2016,Hidalgo,M s de 3 hasta 5 s.m.,693669,411258,282411,0,0,0
2016,Hidalgo,M s de 5 hasta 10 s.m.,82106,65142,16964,0,0,0
2016,Hidalgo,No especificado,20584,14279,6305,0,0,0
2016,Hidalgo,No recibe ingresos,192437,187955,4482,0,0,0
2016,Jalisco,1 salario m¡nimo,4652,4652,0,0,0,0
2016,Jalisco,Menos de 1 s.m.,1269426,1091018,178408,0,0,0
2016,Jalisco,M s de 1 hasta 2 s.m.,40257,29092,11165,0,0,0
2016,Jalisco,M s de 10 s.m.,2437646,1128364,1309282,0,0,0
2016,Jalisco,M s de 2 hasta 3 s.m.,1132270,1085117,47153,0,0,0
2016,Jalisco,M s de 3 hasta 5 s.m.,2638707,1680391,958316,0,0,0
2016,Jalisco,M s de 5 hasta 10 s.m.,529743,383197,146546,0,0,0
2016,Jalisco,No especificado,107330,77083,30247,0,0,0
2016,Jalisco,No recibe ingresos,437458,401729,35729,0,0,0
2016,Michoac n,1 salario m¡nimo,7643,7643,0,0,0,0
2016,Michoac n,Menos de 1 s.m.,1874382,1712882,161500,0,0,0
2016,Michoac n,M s de 1 hasta 2 s.m.,31862,23786,8076,0,0,0
2016,Michoac n,M s de 10 s.m.,1362600,516757,845843,0,0,0
2016,Michoac n,M s de 2 hasta 3 s.m.,569699,557844,11855,0,0,0
2016,Michoac n,M s de 3 hasta 5 s.m.,950775,567726,383049,0,0,0
2016,Michoac n,M s de 5 hasta 10 s.m.,247445,173701,73744,0,0,0
2016,Michoac n,No especificado,28900,17380,11520,0,0,0
2016,Michoac n,No recibe ingresos,243885,231628,12257,0,0,0
2016,Morelos,1 salario m¡nimo,3490,3490,0,0,0,0
2016,Morelos,Menos de 1 s.m.,337167,313329,23838,0,0,0
2016,Morelos,M s de 1 hasta 2 s.m.,10907,9516,1391,0,0,0
2016,Morelos,M s de 10 s.m.,557333,235671,321662,0,0,0
2016,Morelos,M s de 2 hasta 3 s.m.,321338,315859,5479,0,0,0
2016,Morelos,M s de 3 hasta 5 s.m.,383758,235535,148223,0,0,0
2016,Morelos,M s de 5 hasta 10 s.m.,66386,51236,15150,0,0,0
2016,Morelos,No especificado,27088,16277,10811,0,0,0
2016,Morelos,No recibe ingresos,160201,153719,6482,0,0,0
2016,Nacional,1 salario m¡nimo,798127,709830,88297,0,0,0
2016,Nacional,Menos de 1 s.m.,26841026,23968102,2872924,0,0,0
2016,Nacional,M s de 1 hasta 2 s.m.,812715,653201,159514,0,0,0
2016,Nacional,M s de 10 s.m.,33346863,14572911,18773952,0,0,0
2016,Nacional,M s de 2 hasta 3 s.m.,16969641,16408040,561601,0,0,0
2016,Nacional,M s de 3 hasta 5 s.m.,33646696,21109775,12536921,0,0,0
2016,Nacional,M s de 5 hasta 10 s.m.,5749218,4282649,1466569,0,0,0
2016,Nacional,No especificado,1634096,1090866,543230,0,0,0
2016,Nacional,No recibe ingresos,8790516,8085678,704838,0,0,0
2016,Nayarit,1 salario m¡nimo,3910,3390,520,0,0,0
2016,Nayarit,Menos de 1 s.m.,457704,418978,38726,0,0,0
2016,Nayarit,M s de 1 hasta 2 s.m.,9948,7489,2459,0,0,0
2016,Nayarit,M s de 10 s.m.,376644,127410,249234,0,0,0
2016,Nayarit,M s de 2 hasta 3 s.m.,169172,163612,5560,0,0,0
2016,Nayarit,M s de 3 hasta 5 s.m.,170235,89482,80753,0,0,0
2016,Nayarit,M s de 5 hasta 10 s.m.,52422,38902,13520,0,0,0
2016,Nayarit,No especificado,14392,8191,6201,0,0,0
2016,Nayarit,No recibe ingresos,65677,58625,7052,0,0,0
2016,Nuevo Le¢n,1 salario m¡nimo,10001,7951,2050,0,0,0
2016,Nuevo Le¢n,Menos de 1 s.m.,120327,112289,8038,0,0,0
2016,Nuevo Le¢n,M s de 1 hasta 2 s.m.,47895,41400,6495,0,0,0
2016,Nuevo Le¢n,M s de 10 s.m.,1325864,613729,712135,0,0,0
2016,Nuevo Le¢n,M s de 2 hasta 3 s.m.,824458,787319,37139,0,0,0
2016,Nuevo Le¢n,M s de 3 hasta 5 s.m.,2273060,1634087,638973,0,0,0
2016,Nuevo Le¢n,M s de 5 hasta 10 s.m.,363297,264732,98565,0,0,0
2016,Nuevo Le¢n,No especificado,97216,67463,29753,0,0,0
2016,Nuevo Le¢n,No recibe ingresos,500346,451369,48977,0,0,0
2016,Oaxaca,1 salario m¡nimo,27498,22370,5128,0,0,0
2016,Oaxaca,Menos de 1 s.m.,2144062,1853056,291006,0,0,0
2016,Oaxaca,M s de 1 hasta 2 s.m.,9821,6910,2911,0,0,0
2016,Oaxaca,M s de 10 s.m.,952697,289161,663536,0,0,0
2016,Oaxaca,M s de 2 hasta 3 s.m.,490690,479708,10982,0,0,0
2016,Oaxaca,M s de 3 hasta 5 s.m.,854820,344431,510389,0,0,0
2016,Oaxaca,M s de 5 hasta 10 s.m.,87561,68519,19042,0,0,0
2016,Oaxaca,No especificado,13870,8647,5223,0,0,0
2016,Oaxaca,No recibe ingresos,251047,240882,10165,0,0,0
2016,Puebla,1 salario m¡nimo,13945,13058,887,0,0,0
2016,Puebla,Menos de 1 s.m.,2494260,2009911,484349,0,0,0
2016,Puebla,M s de 1 hasta 2 s.m.,26664,20937,5727,0,0,0
2016,Puebla,M s de 10 s.m.,1751447,717797,1033650,0,0,0
2016,Puebla,M s de 2 hasta 3 s.m.,792558,775996,16562,0,0,0
2016,Puebla,M s de 3 hasta 5 s.m.,1710809,1000904,709905,0,0,0
2016,Puebla,M s de 5 hasta 10 s.m.,245135,194936,50199,0,0,0
2016,Puebla,No especificado,59076,38262,20814,0,0,0
2016,Puebla,No recibe ingresos,314005,300142,13863,0,0,0
2016,Queretaro,1 salario m¡nimo,16609,16213,396,0,0,0
2016,Queretaro,Menos de 1 s.m.,155657,141270,14387,0,0,0
2016,Queretaro,M s de 1 hasta 2 s.m.,9396,8979,417,0,0,0
2016,Queretaro,M s de 10 s.m.,435715,207926,227789,0,0,0
2016,Queretaro,M s de 2 hasta 3 s.m.,330546,318760,11786,0,0,0
2016,Queretaro,M s de 3 hasta 5 s.m.,725967,487302,238665,0,0,0
2016,Queretaro,M s de 5 hasta 10 s.m.,112633,92002,20631,0,0,0
2016,Queretaro,No especificado,27146,16668,10478,0,0,0
2016,Queretaro,No recibe ingresos,120116,113640,6476,0,0,0
2016,Quintana Roo,1 salario m¡nimo,1423,1295,128,0,0,0
2016,Quintana Roo,Menos de 1 s.m.,181501,164105,17396,0,0,0
2016,Quintana Roo,M s de 1 hasta 2 s.m.,15657,12338,3319,0,0,0
2016,Quintana Roo,M s de 10 s.m.,461414,208519,252895,0,0,0
2016,Quintana Roo,M s de 2 hasta 3 s.m.,294824,280967,13857,0,0,0
2016,Quintana Roo,M s de 3 hasta 5 s.m.,161433,99315,62118,0,0,0
2016,Quintana Roo,M s de 5 hasta 10 s.m.,75350,56717,18633,0,0,0
2016,Quintana Roo,No especificado,20840,13414,7426,0,0,0
2016,Quintana Roo,No recibe ingresos,175777,159705,16072,0,0,0
2016,San Luis Potos¡,1 salario m¡nimo,18719,17713,1006,0,0,0
2016,San Luis Potos¡,Menos de 1 s.m.,870596,794880,75716,0,0,0
2016,San Luis Potos¡,M s de 1 hasta 2 s.m.,12987,10734,2253,0,0,0
2016,San Luis Potos¡,M s de 10 s.m.,741246,294844,446402,0,0,0
2016,San Luis Potos¡,M s de 2 hasta 3 s.m.,368337,356970,11367,0,0,0
2016,San Luis Potos¡,M s de 3 hasta 5 s.m.,798529,515826,282703,0,0,0
2016,San Luis Potos¡,M s de 5 hasta 10 s.m.,99112,76796,22316,0,0,0
2016,San Luis Potos¡,No especificado,22069,14452,7617,0,0,0
2016,San Luis Potos¡,No recibe ingresos,145100,134025,11075,0,0,0
2016,Sinaloa,1 salario m¡nimo,15999,14746,1253,0,0,0
2016,Sinaloa,Menos de 1 s.m.,893254,754810,138444,0,0,0
2016,Sinaloa,M s de 1 hasta 2 s.m.,38816,34863,3953,0,0,0
2016,Sinaloa,M s de 10 s.m.,922910,389861,533049,0,0,0
2016,Sinaloa,M s de 2 hasta 3 s.m.,446344,425420,20924,0,0,0
2016,Sinaloa,M s de 3 hasta 5 s.m.,532380,313820,218560,0,0,0
2016,Sinaloa,M s de 5 hasta 10 s.m.,165384,122233,43151,0,0,0
2016,Sinaloa,No especificado,41848,17989,23859,0,0,0
2016,Sinaloa,No recibe ingresos,160251,146221,14030,0,0,0
2016,Sonora,1 salario m¡nimo,83476,76579,6897,0,0,0
2016,Sonora,Menos de 1 s.m.,599267,503690,95577,0,0,0
2016,Sonora,M s de 1 hasta 2 s.m.,35773,29262,6511,0,0,0
2016,Sonora,M s de 10 s.m.,799749,324175,475574,0,0,0
2016,Sonora,M s de 2 hasta 3 s.m.,442745,423322,19423,0,0,0
2016,Sonora,M s de 3 hasta 5 s.m.,914506,492805,421701,0,0,0
2016,Sonora,M s de 5 hasta 10 s.m.,173105,129114,43991,0,0,0
2016,Sonora,No especificado,50374,38548,11826,0,0,0
2016,Sonora,No recibe ingresos,149308,135156,14152,0,0,0
2016,Tabasco,1 salario m¡nimo,93707,75986,17721,0,0,0
2016,Tabasco,Menos de 1 s.m.,441504,425524,15980,0,0,0
2016,Tabasco,M s de 1 hasta 2 s.m.,13759,10721,3038,0,0,0
2016,Tabasco,M s de 10 s.m.,663911,317362,346549,0,0,0
2016,Tabasco,M s de 2 hasta 3 s.m.,361107,348257,12850,0,0,0
2016,Tabasco,M s de 3 hasta 5 s.m.,311022,201288,109734,0,0,0
2016,Tabasco,M s de 5 hasta 10 s.m.,110879,88998,21881,0,0,0
2016,Tabasco,No especificado,19440,13753,5687,0,0,0
2016,Tabasco,No recibe ingresos,180016,172420,7596,0,0,0
2016,Tamaulipas,1 salario m¡nimo,34048,32367,1681,0,0,0
2016,Tamaulipas,Menos de 1 s.m.,441514,408360,33154,0,0,0
2016,Tamaulipas,M s de 1 hasta 2 s.m.,34125,29321,4804,0,0,0
2016,Tamaulipas,M s de 10 s.m.,990787,417242,573545,0,0,0
2016,Tamaulipas,M s de 2 hasta 3 s.m.,476932,460426,16506,0,0,0
2016,Tamaulipas,M s de 3 hasta 5 s.m.,1299165,770163,529002,0,0,0
2016,Tamaulipas,M s de 5 hasta 10 s.m.,130891,97055,33836,0,0,0
2016,Tamaulipas,No especificado,49074,24855,24219,0,0,0
2016,Tamaulipas,No recibe ingresos,391154,334186,56968,0,0,0
2016,Tlaxcala,1 salario m¡nimo,1194,1194,0,0,0,0
2016,Tlaxcala,Menos de 1 s.m.,268325,234139,34186,0,0,0
2016,Tlaxcala,M s de 1 hasta 2 s.m.,4886,4093,793,0,0,0
2016,Tlaxcala,M s de 10 s.m.,347596,153303,194293,0,0,0
2016,Tlaxcala,M s de 2 hasta 3 s.m.,223092,218761,4331,0,0,0
2016,Tlaxcala,M s de 3 hasta 5 s.m.,549325,313665,235660,0,0,0
2016,Tlaxcala,M s de 5 hasta 10 s.m.,37677,28767,8910,0,0,0
2016,Tlaxcala,No especificado,5803,3405,2398,0,0,0
2016,Tlaxcala,No recibe ingresos,61687,59859,1828,0,0,0
2016,Veracruz,1 salario m¡nimo,69086,62671,6415,0,0,0
2016,Veracruz,Menos de 1 s.m.,3083569,2945669,137900,0,0,0
2016,Veracruz,M s de 1 hasta 2 s.m.,68036,58329,9707,0,0,0
2016,Veracruz,M s de 10 s.m.,1754558,734847,1019711,0,0,0
2016,Veracruz,M s de 2 hasta 3 s.m.,1096694,1082321,14373,0,0,0
2016,Veracruz,M s de 3 hasta 5 s.m.,1154238,778484,375754,0,0,0
2016,Veracruz,M s de 5 hasta 10 s.m.,243131,195798,47333,0,0,0
2016,Veracruz,No especificado,54777,30378,24399,0,0,0
2016,Veracruz,No recibe ingresos,538295,495897,42398,0,0,0
2016,Yucat n,1 salario m¡nimo,6176,6176,0,0,0,0
2016,Yucat n,Menos de 1 s.m.,450886,432969,17917,0,0,0
2016,Yucat n,M s de 1 hasta 2 s.m.,20794,16051,4743,0,0,0
2016,Yucat n,M s de 10 s.m.,568729,258037,310692,0,0,0
2016,Yucat n,M s de 2 hasta 3 s.m.,363652,352193,11459,0,0,0
2016,Yucat n,M s de 3 hasta 5 s.m.,700325,361391,338934,0,0,0
2016,Yucat n,M s de 5 hasta 10 s.m.,129319,94421,34898,0,0,0
2016,Yucat n,No especificado,37230,24998,12232,0,0,0
2016,Yucat n,No recibe ingresos,156900,145843,11057,0,0,0
2016,Zacatecas,1 salario m¡nimo,45221,43325,1896,0,0,0
2016,Zacatecas,Menos de 1 s.m.,598762,524178,74584,0,0,0
2016,Zacatecas,M s de 1 hasta 2 s.m.,3483,2379,1104,0,0,0
2016,Zacatecas,M s de 10 s.m.,397019,155755,241264,0,0,0
2016,Zacatecas,M s de 2 hasta 3 s.m.,239270,233502,5768,0,0,0
2016,Zacatecas,M s de 3 hasta 5 s.m.,257814,159982,97832,0,0,0
2016,Zacatecas,M s de 5 hasta 10 s.m.,54033,45414,8619,0,0,0
2016,Zacatecas,No especificado,8014,5806,2208,0,0,0
2016,Zacatecas,No recibe ingresos,42843,38422,4421,0,0,0
2017,Aguascalientes,1 salario m¡nimo,10833,9685,1148,0,0,0
2017,Aguascalientes,Menos de 1 s.m.,112819,103114,9705,0,0,0
2017,Aguascalientes,M s de 1 hasta 2 s.m.,4983,3807,1176,0,0,0
2017,Aguascalientes,M s de 10 s.m.,330275,157132,173143,0,0,0
2017,Aguascalientes,M s de 2 hasta 3 s.m.,170677,162669,8008,0,0,0
2017,Aguascalientes,M s de 3 hasta 5 s.m.,543722,372849,170873,0,0,0
2017,Aguascalientes,M s de 5 hasta 10 s.m.,71372,55120,16252,0,0,0
2017,Aguascalientes,No especificado,14348,9197,5151,0,0,0
2017,Aguascalientes,No recibe ingresos,81560,74781,6779,0,0,0
2017,Baja California,1 salario m¡nimo,4051,3557,494,0,0,0
2017,Baja California,Menos de 1 s.m.,302743,219872,82871,0,0,0
2017,Baja California,M s de 1 hasta 2 s.m.,37616,32354,5262,0,0,0
2017,Baja California,M s de 10 s.m.,1062720,532010,530710,0,0,0
2017,Baja California,M s de 2 hasta 3 s.m.,461707,445703,16004,0,0,0
2017,Baja California,M s de 3 hasta 5 s.m.,1557978,927232,630746,0,0,0
2017,Baja California,M s de 5 hasta 10 s.m.,156715,109444,47271,0,0,0
2017,Baja California,No especificado,51732,37476,14256,0,0,0
2017,Baja California,No recibe ingresos,274212,240089,34123,0,0,0
2017,Baja California Sur,1 salario m¡nimo,21279,18769,2510,0,0,0
2017,Baja California Sur,Menos de 1 s.m.,98601,86871,11730,0,0,0
2017,Baja California Sur,M s de 1 hasta 2 s.m.,14901,12841,2060,0,0,0
2017,Baja California Sur,M s de 10 s.m.,222279,97529,124750,0,0,0
2017,Baja California Sur,M s de 2 hasta 3 s.m.,181298,173512,7786,0,0,0
2017,Baja California Sur,M s de 3 hasta 5 s.m.,111127,70326,40801,0,0,0
2017,Baja California Sur,M s de 5 hasta 10 s.m.,41819,30933,10886,0,0,0
2017,Baja California Sur,No especificado,12327,6262,6065,0,0,0
2017,Baja California Sur,No recibe ingresos,55558,47476,8082,0,0,0
2017,Campeche,1 salario m¡nimo,26856,20055,6801,0,0,0
2017,Campeche,Menos de 1 s.m.,316509,298602,17907,0,0,0
2017,Campeche,M s de 1 hasta 2 s.m.,4053,3363,690,0,0,0
2017,Campeche,M s de 10 s.m.,253640,100869,152771,0,0,0
2017,Campeche,M s de 2 hasta 3 s.m.,148034,139197,8837,0,0,0
2017,Campeche,M s de 3 hasta 5 s.m.,134478,70036,64442,0,0,0
2017,Campeche,M s de 5 hasta 10 s.m.,32224,26131,6093,0,0,0
2017,Campeche,No especificado,9274,7129,2145,0,0,0
2017,Campeche,No recibe ingresos,52719,49908,2811,0,0,0
2017,Chiapas,1 salario m¡nimo,14807,14409,398,0,0,0
2017,Chiapas,Menos de 1 s.m.,2968975,2878648,90327,0,0,0
2017,Chiapas,M s de 1 hasta 2 s.m.,13764,9677,4087,0,0,0
2017,Chiapas,M s de 10 s.m.,966785,382611,584174,0,0,0
2017,Chiapas,M s de 2 hasta 3 s.m.,562468,553686,8782,0,0,0
2017,Chiapas,M s de 3 hasta 5 s.m.,643726,330245,313481,0,0,0
2017,Chiapas,M s de 5 hasta 10 s.m.,139467,113836,25631,0,0,0
2017,Chiapas,No especificado,22539,12106,10433,0,0,0
2017,Chiapas,No recibe ingresos,247776,239523,8253,0,0,0
2017,Chihuahua,1 salario m¡nimo,53270,51026,2244,0,0,0
2017,Chihuahua,Menos de 1 s.m.,566683,505342,61341,0,0,0
2017,Chihuahua,M s de 1 hasta 2 s.m.,41311,30916,10395,0,0,0
2017,Chihuahua,M s de 10 s.m.,862181,422792,439389,0,0,0
2017,Chihuahua,M s de 2 hasta 3 s.m.,463731,442087,21644,0,0,0
2017,Chihuahua,M s de 3 hasta 5 s.m.,1967371,1124034,843337,0,0,0
2017,Chihuahua,M s de 5 hasta 10 s.m.,186500,135556,50944,0,0,0
2017,Chihuahua,No especificado,38966,26192,12774,0,0,0
2017,Chihuahua,No recibe ingresos,188010,171028,16982,0,0,0
2017,Ciudad de Mxico,1 salario m¡nimo,3421,1641,1780,0,0,0
2017,Ciudad de Mxico,Menos de 1 s.m.,88769,78017,10752,0,0,0
2017,Ciudad de Mxico,M s de 1 hasta 2 s.m.,43120,36119,7001,0,0,0
2017,Ciudad de Mxico,M s de 10 s.m.,2727182,1301877,1425305,0,0,0
2017,Ciudad de Mxico,M s de 2 hasta 3 s.m.,1045635,941422,104213,0,0,0
2017,Ciudad de Mxico,M s de 3 hasta 5 s.m.,1853552,1150910,702642,0,0,0
2017,Ciudad de Mxico,M s de 5 hasta 10 s.m.,479254,319839,159415,0,0,0
2017,Ciudad de Mxico,No especificado,345329,225156,120173,0,0,0
2017,Ciudad de Mxico,No recibe ingresos,994005,871740,122265,0,0,0
2017,Coahuila,1 salario m¡nimo,45448,43450,1998,0,0,0
2017,Coahuila,Menos de 1 s.m.,218824,201725,17099,0,0,0
2017,Coahuila,M s de 1 hasta 2 s.m.,18693,15648,3045,0,0,0
2017,Coahuila,M s de 10 s.m.,721123,334524,386599,0,0,0
2017,Coahuila,M s de 2 hasta 3 s.m.,468153,444097,24056,0,0,0
2017,Coahuila,M s de 3 hasta 5 s.m.,1555829,1079166,476663,0,0,0
2017,Coahuila,M s de 5 hasta 10 s.m.,135934,108252,27682,0,0,0
2017,Coahuila,No especificado,35355,22754,12601,0,0,0
2017,Coahuila,No recibe ingresos,218141,202330,15811,0,0,0
2017,Colima,1 salario m¡nimo,10164,9541,623,0,0,0
2017,Colima,Menos de 1 s.m.,171528,140197,31331,0,0,0
2017,Colima,M s de 1 hasta 2 s.m.,9281,8310,971,0,0,0
2017,Colima,M s de 10 s.m.,204330,79946,124384,0,0,0
2017,Colima,M s de 2 hasta 3 s.m.,112089,107581,4508,0,0,0
2017,Colima,M s de 3 hasta 5 s.m.,125167,69906,55261,0,0,0
2017,Colima,M s de 5 hasta 10 s.m.,41446,30747,10699,0,0,0
2017,Colima,No especificado,11266,6312,4954,0,0,0
2017,Colima,No recibe ingresos,103534,88277,15257,0,0,0
2017,Durango,1 salario m¡nimo,53080,49671,3409,0,0,0
2017,Durango,Menos de 1 s.m.,403109,375425,27684,0,0,0
2017,Durango,M s de 1 hasta 2 s.m.,9887,7824,2063,0,0,0
2017,Durango,M s de 10 s.m.,480791,189287,291504,0,0,0
2017,Durango,M s de 2 hasta 3 s.m.,289555,280779,8776,0,0,0
2017,Durango,M s de 3 hasta 5 s.m.,482759,317077,165682,0,0,0
2017,Durango,M s de 5 hasta 10 s.m.,66623,47719,18904,0,0,0
2017,Durango,No especificado,16057,10368,5689,0,0,0
2017,Durango,No recibe ingresos,113217,106490,6727,0,0,0
2017,Estado de Mxico,1 salario m¡nimo,49848,48943,905,0,0,0
2017,Estado de Mxico,Menos de 1 s.m.,1241560,1112642,128918,0,0,0
2017,Estado de Mxico,M s de 1 hasta 2 s.m.,104015,75564,28451,0,0,0
2017,Estado de Mxico,M s de 10 s.m.,5248596,2604477,2644119,0,0,0
2017,Estado de Mxico,M s de 2 hasta 3 s.m.,2381372,2319698,61674,0,0,0
2017,Estado de Mxico,M s de 3 hasta 5 s.m.,5240462,3519658,1720804,0,0,0
2017,Estado de Mxico,M s de 5 hasta 10 s.m.,921703,667765,253938,0,0,0
2017,Estado de Mxico,No especificado,315434,226726,88708,0,0,0
2017,Estado de Mxico,No recibe ingresos,1888919,1718924,169995,0,0,0
2017,Guanajuato,1 salario m¡nimo,34865,29189,5676,0,0,0
2017,Guanajuato,Menos de 1 s.m.,994569,830170,164399,0,0,0
2017,Guanajuato,M s de 1 hasta 2 s.m.,33668,26943,6725,0,0,0
2017,Guanajuato,M s de 10 s.m.,1492825,659825,833000,0,0,0
2017,Guanajuato,M s de 2 hasta 3 s.m.,958045,928636,29409,0,0,0
2017,Guanajuato,M s de 3 hasta 5 s.m.,2414150,1593795,820355,0,0,0
2017,Guanajuato,M s de 5 hasta 10 s.m.,364595,272350,92245,0,0,0
2017,Guanajuato,No especificado,33118,19639,13479,0,0,0
2017,Guanajuato,No recibe ingresos,319174,296325,22849,0,0,0
2017,Guerrero,1 salario m¡nimo,29765,28210,1555,0,0,0
2017,Guerrero,Menos de 1 s.m.,1807534,1501901,305633,0,0,0
2017,Guerrero,M s de 1 hasta 2 s.m.,22105,20064,2041,0,0,0
2017,Guerrero,M s de 10 s.m.,781984,267531,514453,0,0,0
2017,Guerrero,M s de 2 hasta 3 s.m.,354293,347231,7062,0,0,0
2017,Guerrero,M s de 3 hasta 5 s.m.,529078,270320,258758,0,0,0
2017,Guerrero,M s de 5 hasta 10 s.m.,75682,62217,13465,0,0,0
2017,Guerrero,No especificado,17583,12105,5478,0,0,0
2017,Guerrero,No recibe ingresos,196545,191881,4664,0,0,0
2017,Hidalgo,1 salario m¡nimo,16910,16910,0,0,0,0
2017,Hidalgo,Menos de 1 s.m.,924165,788341,135824,0,0,0
2017,Hidalgo,M s de 1 hasta 2 s.m.,15231,11046,4185,0,0,0
2017,Hidalgo,M s de 10 s.m.,722384,310713,411671,0,0,0
2017,Hidalgo,M s de 2 hasta 3 s.m.,470000,459503,10497,0,0,0
2017,Hidalgo,M s de 3 hasta 5 s.m.,767257,455421,311836,0,0,0
2017,Hidalgo,M s de 5 hasta 10 s.m.,113220,92987,20233,0,0,0
2017,Hidalgo,No especificado,16890,8444,8446,0,0,0
2017,Hidalgo,No recibe ingresos,148848,143278,5570,0,0,0
2017,Jalisco,1 salario m¡nimo,12726,12349,377,0,0,0
2017,Jalisco,Menos de 1 s.m.,1329852,1166461,163391,0,0,0
2017,Jalisco,M s de 1 hasta 2 s.m.,32384,23564,8820,0,0,0
2017,Jalisco,M s de 10 s.m.,2427120,1041258,1385862,0,0,0
2017,Jalisco,M s de 2 hasta 3 s.m.,1169041,1127817,41224,0,0,0
2017,Jalisco,M s de 3 hasta 5 s.m.,2694853,1752278,942575,0,0,0
2017,Jalisco,M s de 5 hasta 10 s.m.,524181,374973,149208,0,0,0
2017,Jalisco,No especificado,105007,68390,36617,0,0,0
2017,Jalisco,No recibe ingresos,528852,469431,59421,0,0,0
2017,Michoac n,1 salario m¡nimo,3021,3021,0,0,0,0
2017,Michoac n,Menos de 1 s.m.,1967706,1772658,195048,0,0,0
2017,Michoac n,M s de 1 hasta 2 s.m.,15979,13667,2312,0,0,0
2017,Michoac n,M s de 10 s.m.,1288800,497124,791676,0,0,0
2017,Michoac n,M s de 2 hasta 3 s.m.,614523,603994,10529,0,0,0
2017,Michoac n,M s de 3 hasta 5 s.m.,839464,526840,312624,0,0,0
2017,Michoac n,M s de 5 hasta 10 s.m.,227676,174798,52878,0,0,0
2017,Michoac n,No especificado,34407,19995,14412,0,0,0
2017,Michoac n,No recibe ingresos,196868,186899,9969,0,0,0
2017,Morelos,1 salario m¡nimo,1525,1012,513,0,0,0
2017,Morelos,Menos de 1 s.m.,363978,339112,24866,0,0,0
2017,Morelos,M s de 1 hasta 2 s.m.,9997,7268,2729,0,0,0
2017,Morelos,M s de 10 s.m.,578892,248970,329922,0,0,0
2017,Morelos,M s de 2 hasta 3 s.m.,298785,294117,4668,0,0,0
2017,Morelos,M s de 3 hasta 5 s.m.,384347,243961,140386,0,0,0
2017,Morelos,M s de 5 hasta 10 s.m.,77326,61677,15649,0,0,0
2017,Morelos,No especificado,28334,18733,9601,0,0,0
2017,Morelos,No recibe ingresos,156644,148128,8516,0,0,0
2017,Nacional,1 salario m¡nimo,805719,739625,66094,0,0,0
2017,Nacional,Menos de 1 s.m.,27245074,24205277,3039797,0,0,0
2017,Nacional,M s de 1 hasta 2 s.m.,825086,675976,149110,0,0,0
2017,Nacional,M s de 10 s.m.,32780799,14515335,18265464,0,0,0
2017,Nacional,M s de 2 hasta 3 s.m.,17112136,16518435,593701,0,0,0
2017,Nacional,M s de 3 hasta 5 s.m.,34765352,21748059,13017293,0,0,0
2017,Nacional,M s de 5 hasta 10 s.m.,5862654,4348779,1513875,0,0,0
2017,Nacional,No especificado,1606170,1050883,555287,0,0,0
2017,Nacional,No recibe ingresos,9068954,8288579,780375,0,0,0
2017,Nayarit,1 salario m¡nimo,3374,2269,1105,0,0,0
2017,Nayarit,Menos de 1 s.m.,458948,421433,37515,0,0,0
2017,Nayarit,M s de 1 hasta 2 s.m.,8671,7078,1593,0,0,0
2017,Nayarit,M s de 10 s.m.,397110,146261,250849,0,0,0
2017,Nayarit,M s de 2 hasta 3 s.m.,175439,169596,5843,0,0,0
2017,Nayarit,M s de 3 hasta 5 s.m.,179770,97046,82724,0,0,0
2017,Nayarit,M s de 5 hasta 10 s.m.,60574,46531,14043,0,0,0
2017,Nayarit,No especificado,14548,7804,6744,0,0,0
2017,Nayarit,No recibe ingresos,68363,63081,5282,0,0,0
2017,Nuevo Le¢n,1 salario m¡nimo,11512,10250,1262,0,0,0
2017,Nuevo Le¢n,Menos de 1 s.m.,153142,140890,12252,0,0,0
2017,Nuevo Le¢n,M s de 1 hasta 2 s.m.,48702,44575,4127,0,0,0
2017,Nuevo Le¢n,M s de 10 s.m.,1333691,647520,686171,0,0,0
2017,Nuevo Le¢n,M s de 2 hasta 3 s.m.,827773,773856,53917,0,0,0
2017,Nuevo Le¢n,M s de 3 hasta 5 s.m.,2281379,1639449,641930,0,0,0
2017,Nuevo Le¢n,M s de 5 hasta 10 s.m.,384299,269496,114803,0,0,0
2017,Nuevo Le¢n,No especificado,87648,63491,24157,0,0,0
2017,Nuevo Le¢n,No recibe ingresos,514330,465692,48638,0,0,0
2017,Oaxaca,1 salario m¡nimo,15279,15208,71,0,0,0
2017,Oaxaca,Menos de 1 s.m.,2174343,1881014,293329,0,0,0
2017,Oaxaca,M s de 1 hasta 2 s.m.,10382,6768,3614,0,0,0
2017,Oaxaca,M s de 10 s.m.,891384,281974,609410,0,0,0
2017,Oaxaca,M s de 2 hasta 3 s.m.,437669,430409,7260,0,0,0
2017,Oaxaca,M s de 3 hasta 5 s.m.,878670,322404,556266,0,0,0
2017,Oaxaca,M s de 5 hasta 10 s.m.,89092,72125,16967,0,0,0
2017,Oaxaca,No especificado,12144,8900,3244,0,0,0
2017,Oaxaca,No recibe ingresos,242679,231395,11284,0,0,0
2017,Puebla,1 salario m¡nimo,13580,13194,386,0,0,0
2017,Puebla,Menos de 1 s.m.,2506184,1976707,529477,0,0,0
2017,Puebla,M s de 1 hasta 2 s.m.,32356,25902,6454,0,0,0
2017,Puebla,M s de 10 s.m.,1684460,708062,976398,0,0,0
2017,Puebla,M s de 2 hasta 3 s.m.,889262,868199,21063,0,0,0
2017,Puebla,M s de 3 hasta 5 s.m.,1956258,1143473,812785,0,0,0
2017,Puebla,M s de 5 hasta 10 s.m.,252992,187552,65440,0,0,0
2017,Puebla,No especificado,50077,32576,17501,0,0,0
2017,Puebla,No recibe ingresos,346468,327569,18899,0,0,0
2017,Queretaro,1 salario m¡nimo,19913,19394,519,0,0,0
2017,Queretaro,Menos de 1 s.m.,188280,174621,13659,0,0,0
2017,Queretaro,M s de 1 hasta 2 s.m.,11638,10269,1369,0,0,0
2017,Queretaro,M s de 10 s.m.,415267,184468,230799,0,0,0
2017,Queretaro,M s de 2 hasta 3 s.m.,352534,339426,13108,0,0,0
2017,Queretaro,M s de 3 hasta 5 s.m.,715950,486911,229039,0,0,0
2017,Queretaro,M s de 5 hasta 10 s.m.,99730,78318,21412,0,0,0
2017,Queretaro,No especificado,28359,18161,10198,0,0,0
2017,Queretaro,No recibe ingresos,140299,130872,9427,0,0,0
2017,Quintana Roo,1 salario m¡nimo,355,355,0,0,0,0
2017,Quintana Roo,Menos de 1 s.m.,170637,159455,11182,0,0,0
2017,Quintana Roo,M s de 1 hasta 2 s.m.,8912,7388,1524,0,0,0
2017,Quintana Roo,M s de 10 s.m.,473640,212038,261602,0,0,0
2017,Quintana Roo,M s de 2 hasta 3 s.m.,279081,265761,13320,0,0,0
2017,Quintana Roo,M s de 3 hasta 5 s.m.,193026,119093,73933,0,0,0
2017,Quintana Roo,M s de 5 hasta 10 s.m.,79527,61748,17779,0,0,0
2017,Quintana Roo,No especificado,20380,10084,10296,0,0,0
2017,Quintana Roo,No recibe ingresos,196177,177085,19092,0,0,0
2017,San Luis Potos¡,1 salario m¡nimo,21016,19552,1464,0,0,0
2017,San Luis Potos¡,Menos de 1 s.m.,842997,775488,67509,0,0,0
2017,San Luis Potos¡,M s de 1 hasta 2 s.m.,14841,12126,2715,0,0,0
2017,San Luis Potos¡,M s de 10 s.m.,690606,280473,410133,0,0,0
2017,San Luis Potos¡,M s de 2 hasta 3 s.m.,392258,381587,10671,0,0,0
2017,San Luis Potos¡,M s de 3 hasta 5 s.m.,855780,541885,313895,0,0,0
2017,San Luis Potos¡,M s de 5 hasta 10 s.m.,101221,76722,24499,0,0,0
2017,San Luis Potos¡,No especificado,24717,15888,8829,0,0,0
2017,San Luis Potos¡,No recibe ingresos,149105,140634,8471,0,0,0
2017,Sinaloa,1 salario m¡nimo,30606,30383,223,0,0,0
2017,Sinaloa,Menos de 1 s.m.,843059,718272,124787,0,0,0
2017,Sinaloa,M s de 1 hasta 2 s.m.,29211,24727,4484,0,0,0
2017,Sinaloa,M s de 10 s.m.,887555,384492,503063,0,0,0
2017,Sinaloa,M s de 2 hasta 3 s.m.,473900,460579,13321,0,0,0
2017,Sinaloa,M s de 3 hasta 5 s.m.,585370,335945,249425,0,0,0
2017,Sinaloa,M s de 5 hasta 10 s.m.,170486,125343,45143,0,0,0
2017,Sinaloa,No especificado,37519,19204,18315,0,0,0
2017,Sinaloa,No recibe ingresos,153586,141528,12058,0,0,0
2017,Sonora,1 salario m¡nimo,58768,54640,4128,0,0,0
2017,Sonora,Menos de 1 s.m.,618736,503339,115397,0,0,0
2017,Sonora,M s de 1 hasta 2 s.m.,46778,41728,5050,0,0,0
2017,Sonora,M s de 10 s.m.,772298,348520,423778,0,0,0
2017,Sonora,M s de 2 hasta 3 s.m.,445958,435290,10668,0,0,0
2017,Sonora,M s de 3 hasta 5 s.m.,974329,522448,451881,0,0,0
2017,Sonora,M s de 5 hasta 10 s.m.,200382,152006,48376,0,0,0
2017,Sonora,No especificado,45708,33713,11995,0,0,0
2017,Sonora,No recibe ingresos,151149,134857,16292,0,0,0
2017,Tabasco,1 salario m¡nimo,93171,75859,17312,0,0,0
2017,Tabasco,Menos de 1 s.m.,578112,561770,16342,0,0,0
2017,Tabasco,M s de 1 hasta 2 s.m.,16361,13316,3045,0,0,0
2017,Tabasco,M s de 10 s.m.,614960,299469,315491,0,0,0
2017,Tabasco,M s de 2 hasta 3 s.m.,276947,268735,8212,0,0,0
2017,Tabasco,M s de 3 hasta 5 s.m.,322872,200548,122324,0,0,0
2017,Tabasco,M s de 5 hasta 10 s.m.,95786,75233,20553,0,0,0
2017,Tabasco,No especificado,15365,10930,4435,0,0,0
2017,Tabasco,No recibe ingresos,182765,176074,6691,0,0,0
2017,Tamaulipas,1 salario m¡nimo,42782,37917,4865,0,0,0
2017,Tamaulipas,Menos de 1 s.m.,438878,413986,24892,0,0,0
2017,Tamaulipas,M s de 1 hasta 2 s.m.,50819,43553,7266,0,0,0
2017,Tamaulipas,M s de 10 s.m.,975913,428406,547507,0,0,0
2017,Tamaulipas,M s de 2 hasta 3 s.m.,484121,469537,14584,0,0,0
2017,Tamaulipas,M s de 3 hasta 5 s.m.,1291685,803165,488520,0,0,0
2017,Tamaulipas,M s de 5 hasta 10 s.m.,136002,96094,39908,0,0,0
2017,Tamaulipas,No especificado,47964,29741,18223,0,0,0
2017,Tamaulipas,No recibe ingresos,376497,326119,50378,0,0,0
2017,Tlaxcala,1 salario m¡nimo,1231,1231,0,0,0,0
2017,Tlaxcala,Menos de 1 s.m.,233609,210074,23535,0,0,0
2017,Tlaxcala,M s de 1 hasta 2 s.m.,2857,1840,1017,0,0,0
2017,Tlaxcala,M s de 10 s.m.,364010,154016,209994,0,0,0
2017,Tlaxcala,M s de 2 hasta 3 s.m.,226314,221898,4416,0,0,0
2017,Tlaxcala,M s de 3 hasta 5 s.m.,583695,347230,236465,0,0,0
2017,Tlaxcala,M s de 5 hasta 10 s.m.,44292,37545,6747,0,0,0
2017,Tlaxcala,No especificado,5648,3264,2384,0,0,0
2017,Tlaxcala,No recibe ingresos,62089,59274,2815,0,0,0
2017,Veracruz,1 salario m¡nimo,51389,49075,2314,0,0,0
2017,Veracruz,Menos de 1 s.m.,3139769,2943667,196102,0,0,0
2017,Veracruz,M s de 1 hasta 2 s.m.,86555,75936,10619,0,0,0
2017,Veracruz,M s de 10 s.m.,1957947,803853,1154094,0,0,0
2017,Veracruz,M s de 2 hasta 3 s.m.,1083358,1065987,17371,0,0,0
2017,Veracruz,M s de 3 hasta 5 s.m.,1056548,759811,296737,0,0,0
2017,Veracruz,M s de 5 hasta 10 s.m.,307240,244023,63217,0,0,0
2017,Veracruz,No especificado,60740,26408,34332,0,0,0
2017,Veracruz,No recibe ingresos,531039,492034,39005,0,0,0
2017,Yucat n,1 salario m¡nimo,6418,5692,726,0,0,0
2017,Yucat n,Menos de 1 s.m.,448011,425648,22363,0,0,0
2017,Yucat n,M s de 1 hasta 2 s.m.,20775,17380,3395,0,0,0
2017,Yucat n,M s de 10 s.m.,554789,246833,307956,0,0,0
2017,Yucat n,M s de 2 hasta 3 s.m.,356619,340975,15644,0,0,0
2017,Yucat n,M s de 3 hasta 5 s.m.,747927,371166,376761,0,0,0
2017,Yucat n,M s de 5 hasta 10 s.m.,118574,86971,31603,0,0,0
2017,Yucat n,No especificado,36254,26344,9910,0,0,0
2017,Yucat n,No recibe ingresos,148054,138413,9641,0,0,0
2017,Zacatecas,1 salario m¡nimo,44456,43168,1288,0,0,0
2017,Zacatecas,Menos de 1 s.m.,572445,499815,72630,0,0,0
2017,Zacatecas,M s de 1 hasta 2 s.m.,5240,4415,825,0,0,0
2017,Zacatecas,M s de 10 s.m.,395262,160475,234787,0,0,0
2017,Zacatecas,M s de 2 hasta 3 s.m.,261497,254871,6626,0,0,0
2017,Zacatecas,M s de 3 hasta 5 s.m.,296773,183431,113342,0,0,0
2017,Zacatecas,M s de 5 hasta 10 s.m.,66720,54728,11992,0,0,0
2017,Zacatecas,No especificado,11133,7391,3742,0,0,0
2017,Zacatecas,No recibe ingresos,41772,37444,4328,0,0,0
2018,Aguascalientes,1 salario m¡nimo,8957,8777,180,0,0,0
2018,Aguascalientes,Menos de 1 s.m.,111973,104423,7550,0,0,0
2018,Aguascalientes,M s de 1 hasta 2 s.m.,7216,4706,2510,0,0,0
2018,Aguascalientes,M s de 10 s.m.,326931,154255,172676,0,0,0
2018,Aguascalientes,M s de 2 hasta 3 s.m.,182576,173969,8607,0,0,0
2018,Aguascalientes,M s de 3 hasta 5 s.m.,562894,381035,181859,0,0,0
2018,Aguascalientes,M s de 5 hasta 10 s.m.,76321,57183,19138,0,0,0
2018,Aguascalientes,No especificado,15219,8499,6720,0,0,0
2018,Aguascalientes,No recibe ingresos,85493,81053,4440,0,0,0
2018,Baja California,1 salario m¡nimo,3429,3429,0,0,0,0
2018,Baja California,Menos de 1 s.m.,299611,214993,84618,0,0,0
2018,Baja California,M s de 1 hasta 2 s.m.,21251,18479,2772,0,0,0
2018,Baja California,M s de 10 s.m.,1062984,507081,555903,0,0,0
2018,Baja California,M s de 2 hasta 3 s.m.,459737,441012,18725,0,0,0
2018,Baja California,M s de 3 hasta 5 s.m.,1627538,970662,656876,0,0,0
2018,Baja California,M s de 5 hasta 10 s.m.,187466,120588,66878,0,0,0
2018,Baja California,No especificado,44669,29770,14899,0,0,0
2018,Baja California,No recibe ingresos,292818,269091,23727,0,0,0
2018,Baja California Sur,1 salario m¡nimo,21068,18568,2500,0,0,0
2018,Baja California Sur,Menos de 1 s.m.,103328,84241,19087,0,0,0
2018,Baja California Sur,M s de 1 hasta 2 s.m.,12676,10543,2133,0,0,0
2018,Baja California Sur,M s de 10 s.m.,238576,106033,132543,0,0,0
2018,Baja California Sur,M s de 2 hasta 3 s.m.,177663,166038,11625,0,0,0
2018,Baja California Sur,M s de 3 hasta 5 s.m.,101897,66918,34979,0,0,0
2018,Baja California Sur,M s de 5 hasta 10 s.m.,43760,32899,10861,0,0,0
2018,Baja California Sur,No especificado,11347,6436,4911,0,0,0
2018,Baja California Sur,No recibe ingresos,62044,54337,7707,0,0,0
2018,Campeche,1 salario m¡nimo,30214,21870,8344,0,0,0
2018,Campeche,Menos de 1 s.m.,341841,322472,19369,0,0,0
2018,Campeche,M s de 1 hasta 2 s.m.,4467,3636,831,0,0,0
2018,Campeche,M s de 10 s.m.,260720,106098,154622,0,0,0
2018,Campeche,M s de 2 hasta 3 s.m.,138038,130623,7415,0,0,0
2018,Campeche,M s de 3 hasta 5 s.m.,149444,73113,76331,0,0,0
2018,Campeche,M s de 5 hasta 10 s.m.,28909,23215,5694,0,0,0
2018,Campeche,No especificado,10116,7036,3080,0,0,0
2018,Campeche,No recibe ingresos,52250,49133,3117,0,0,0
2018,Chiapas,1 salario m¡nimo,12608,12223,385,0,0,0
2018,Chiapas,Menos de 1 s.m.,3099858,2990410,109448,0,0,0
2018,Chiapas,M s de 1 hasta 2 s.m.,17897,15058,2839,0,0,0
2018,Chiapas,M s de 10 s.m.,943155,348494,594661,0,0,0
2018,Chiapas,M s de 2 hasta 3 s.m.,514164,502727,11437,0,0,0
2018,Chiapas,M s de 3 hasta 5 s.m.,541488,302280,239208,0,0,0
2018,Chiapas,M s de 5 hasta 10 s.m.,151468,124891,26577,0,0,0
2018,Chiapas,No especificado,24439,13081,11358,0,0,0
2018,Chiapas,No recibe ingresos,287936,280161,7775,0,0,0
2018,Chihuahua,1 salario m¡nimo,67534,65549,1985,0,0,0
2018,Chihuahua,Menos de 1 s.m.,540803,476562,64241,0,0,0
2018,Chihuahua,M s de 1 hasta 2 s.m.,43646,37605,6041,0,0,0
2018,Chihuahua,M s de 10 s.m.,982411,481229,501182,0,0,0
2018,Chihuahua,M s de 2 hasta 3 s.m.,434376,415676,18700,0,0,0
2018,Chihuahua,M s de 3 hasta 5 s.m.,1969661,1132938,836723,0,0,0
2018,Chihuahua,M s de 5 hasta 10 s.m.,178190,127562,50628,0,0,0
2018,Chihuahua,No especificado,54161,31811,22350,0,0,0
2018,Chihuahua,No recibe ingresos,230161,207561,22600,0,0,0
2018,Ciudad de Mxico,1 salario m¡nimo,4214,3442,772,0,0,0
2018,Ciudad de Mxico,Menos de 1 s.m.,63949,58467,5482,0,0,0
2018,Ciudad de Mxico,M s de 1 hasta 2 s.m.,57115,38123,18992,0,0,0
2018,Ciudad de Mxico,M s de 10 s.m.,2920357,1483950,1436407,0,0,0
2018,Ciudad de Mxico,M s de 2 hasta 3 s.m.,923210,828721,94489,0,0,0
2018,Ciudad de Mxico,M s de 3 hasta 5 s.m.,1772865,1068295,704570,0,0,0
2018,Ciudad de Mxico,M s de 5 hasta 10 s.m.,508574,332635,175939,0,0,0
2018,Ciudad de Mxico,No especificado,385713,236693,149020,0,0,0
2018,Ciudad de Mxico,No recibe ingresos,1077839,960304,117535,0,0,0
2018,Coahuila,1 salario m¡nimo,66370,63368,3002,0,0,0
2018,Coahuila,Menos de 1 s.m.,223432,203969,19463,0,0,0
2018,Coahuila,M s de 1 hasta 2 s.m.,22957,20791,2166,0,0,0
2018,Coahuila,M s de 10 s.m.,761499,343768,417731,0,0,0
2018,Coahuila,M s de 2 hasta 3 s.m.,431464,416825,14639,0,0,0
2018,Coahuila,M s de 3 hasta 5 s.m.,1608413,1105919,502494,0,0,0
2018,Coahuila,M s de 5 hasta 10 s.m.,144123,108869,35254,0,0,0
2018,Coahuila,No especificado,26973,15183,11790,0,0,0
2018,Coahuila,No recibe ingresos,233139,214288,18851,0,0,0
2018,Colima,1 salario m¡nimo,11370,10211,1159,0,0,0
2018,Colima,Menos de 1 s.m.,175622,144455,31167,0,0,0
2018,Colima,M s de 1 hasta 2 s.m.,8424,6767,1657,0,0,0
2018,Colima,M s de 10 s.m.,220057,84752,135305,0,0,0
2018,Colima,M s de 2 hasta 3 s.m.,111800,106118,5682,0,0,0
2018,Colima,M s de 3 hasta 5 s.m.,141107,77290,63817,0,0,0
2018,Colima,M s de 5 hasta 10 s.m.,44909,32746,12163,0,0,0
2018,Colima,No especificado,8784,5429,3355,0,0,0
2018,Colima,No recibe ingresos,118534,99008,19526,0,0,0
2018,Durango,1 salario m¡nimo,49359,43203,6156,0,0,0
2018,Durango,Menos de 1 s.m.,414842,396978,17864,0,0,0
2018,Durango,M s de 1 hasta 2 s.m.,10396,6868,3528,0,0,0
2018,Durango,M s de 10 s.m.,505109,209794,295315,0,0,0
2018,Durango,M s de 2 hasta 3 s.m.,285651,277081,8570,0,0,0
2018,Durango,M s de 3 hasta 5 s.m.,512530,328005,184525,0,0,0
2018,Durango,M s de 5 hasta 10 s.m.,66480,51148,15332,0,0,0
2018,Durango,No especificado,17581,10456,7125,0,0,0
2018,Durango,No recibe ingresos,106860,99794,7066,0,0,0
2018,Estado de Mxico,1 salario m¡nimo,56036,56036,0,0,0,0
2018,Estado de Mxico,Menos de 1 s.m.,1390897,1214156,176741,0,0,0
2018,Estado de Mxico,M s de 1 hasta 2 s.m.,108026,86054,21972,0,0,0
2018,Estado de Mxico,M s de 10 s.m.,5533236,2721866,2811370,0,0,0
2018,Estado de Mxico,M s de 2 hasta 3 s.m.,2560159,2431905,128254,0,0,0
2018,Estado de Mxico,M s de 3 hasta 5 s.m.,5576009,3770725,1805284,0,0,0
2018,Estado de Mxico,M s de 5 hasta 10 s.m.,981482,682116,299366,0,0,0
2018,Estado de Mxico,No especificado,247377,165153,82224,0,0,0
2018,Estado de Mxico,No recibe ingresos,1927297,1752788,174509,0,0,0
2018,Guanajuato,1 salario m¡nimo,30098,23330,6768,0,0,0
2018,Guanajuato,Menos de 1 s.m.,1049010,866512,182498,0,0,0
2018,Guanajuato,M s de 1 hasta 2 s.m.,22764,17155,5609,0,0,0
2018,Guanajuato,M s de 10 s.m.,1418274,601498,816776,0,0,0
2018,Guanajuato,M s de 2 hasta 3 s.m.,946227,918609,27618,0,0,0
2018,Guanajuato,M s de 3 hasta 5 s.m.,2776265,1807503,968762,0,0,0
2018,Guanajuato,M s de 5 hasta 10 s.m.,415893,306461,109432,0,0,0
2018,Guanajuato,No especificado,30933,19700,11233,0,0,0
2018,Guanajuato,No recibe ingresos,283077,266634,16443,0,0,0
2018,Guerrero,1 salario m¡nimo,25859,25352,507,0,0,0
2018,Guerrero,Menos de 1 s.m.,1723803,1466497,257306,0,0,0
2018,Guerrero,M s de 1 hasta 2 s.m.,23643,18973,4670,0,0,0
2018,Guerrero,M s de 10 s.m.,781492,272392,509100,0,0,0
2018,Guerrero,M s de 2 hasta 3 s.m.,434578,428310,6268,0,0,0
2018,Guerrero,M s de 3 hasta 5 s.m.,557180,241498,315682,0,0,0
2018,Guerrero,M s de 5 hasta 10 s.m.,80655,65890,14765,0,0,0
2018,Guerrero,No especificado,22231,12292,9939,0,0,0
2018,Guerrero,No recibe ingresos,191351,186811,4540,0,0,0
2018,Hidalgo,1 salario m¡nimo,19783,19783,0,0,0,0
2018,Hidalgo,Menos de 1 s.m.,977043,834057,142986,0,0,0
2018,Hidalgo,M s de 1 hasta 2 s.m.,13771,11130,2641,0,0,0
2018,Hidalgo,M s de 10 s.m.,842472,357348,485124,0,0,0
2018,Hidalgo,M s de 2 hasta 3 s.m.,478653,464533,14120,0,0,0
2018,Hidalgo,M s de 3 hasta 5 s.m.,749124,453248,295876,0,0,0
2018,Hidalgo,M s de 5 hasta 10 s.m.,113225,85752,27473,0,0,0
2018,Hidalgo,No especificado,17526,8657,8869,0,0,0
2018,Hidalgo,No recibe ingresos,168897,161572,7325,0,0,0
2018,Jalisco,1 salario m¡nimo,12235,11702,533,0,0,0
2018,Jalisco,Menos de 1 s.m.,1257153,1087350,169803,0,0,0
2018,Jalisco,M s de 1 hasta 2 s.m.,39293,29643,9650,0,0,0
2018,Jalisco,M s de 10 s.m.,2358927,1048174,1310753,0,0,0
2018,Jalisco,M s de 2 hasta 3 s.m.,1247714,1205106,42608,0,0,0
2018,Jalisco,M s de 3 hasta 5 s.m.,2676525,1726332,950193,0,0,0
2018,Jalisco,M s de 5 hasta 10 s.m.,528918,394922,133996,0,0,0
2018,Jalisco,No especificado,113733,80416,33317,0,0,0
2018,Jalisco,No recibe ingresos,584652,506499,78153,0,0,0
2018,Michoac n,1 salario m¡nimo,1580,1580,0,0,0,0
2018,Michoac n,Menos de 1 s.m.,1986498,1763091,223407,0,0,0
2018,Michoac n,M s de 1 hasta 2 s.m.,21933,20740,1193,0,0,0
2018,Michoac n,M s de 10 s.m.,1318051,504227,813824,0,0,0
2018,Michoac n,M s de 2 hasta 3 s.m.,684320,668381,15939,0,0,0
2018,Michoac n,M s de 3 hasta 5 s.m.,839807,505090,334717,0,0,0
2018,Michoac n,M s de 5 hasta 10 s.m.,305705,226898,78807,0,0,0
2018,Michoac n,No especificado,33500,20322,13178,0,0,0
2018,Michoac n,No recibe ingresos,235031,212459,22572,0,0,0
2018,Morelos,1 salario m¡nimo,4312,4312,0,0,0,0
2018,Morelos,Menos de 1 s.m.,421442,380345,41097,0,0,0
2018,Morelos,M s de 1 hasta 2 s.m.,12440,9122,3318,0,0,0
2018,Morelos,M s de 10 s.m.,539656,231595,308061,0,0,0
2018,Morelos,M s de 2 hasta 3 s.m.,330224,324561,5663,0,0,0
2018,Morelos,M s de 3 hasta 5 s.m.,392640,255485,137155,0,0,0
2018,Morelos,M s de 5 hasta 10 s.m.,79884,62365,17519,0,0,0
2018,Morelos,No especificado,25525,17821,7704,0,0,0
2018,Morelos,No recibe ingresos,153929,146704,7225,0,0,0
2018,Nacional,1 salario m¡nimo,816592,742011,74581,0,0,0
2018,Nacional,Menos de 1 s.m.,27305919,24349507,2956412,0,0,0
2018,Nacional,M s de 1 hasta 2 s.m.,834921,681057,153864,0,0,0
2018,Nacional,M s de 10 s.m.,33760298,14939482,18820816,0,0,0
2018,Nacional,M s de 2 hasta 3 s.m.,17680279,16992190,688089,0,0,0
2018,Nacional,M s de 3 hasta 5 s.m.,35762628,22284206,13478422,0,0,0
2018,Nacional,M s de 5 hasta 10 s.m.,6318912,4597430,1721482,0,0,0
2018,Nacional,No especificado,1611729,1030402,581327,0,0,0
2018,Nacional,No recibe ingresos,9659040,8825489,833551,0,0,0
2018,Nayarit,1 salario m¡nimo,1276,1093,183,0,0,0
2018,Nayarit,Menos de 1 s.m.,481375,444920,36455,0,0,0
2018,Nayarit,M s de 1 hasta 2 s.m.,8608,6935,1673,0,0,0
2018,Nayarit,M s de 10 s.m.,406267,143470,262797,0,0,0
2018,Nayarit,M s de 2 hasta 3 s.m.,182952,176928,6024,0,0,0
2018,Nayarit,M s de 3 hasta 5 s.m.,192244,95743,96501,0,0,0
2018,Nayarit,M s de 5 hasta 10 s.m.,62443,49143,13300,0,0,0
2018,Nayarit,No especificado,16777,9767,7010,0,0,0
2018,Nayarit,No recibe ingresos,72069,67486,4583,0,0,0
2018,Nuevo Le¢n,1 salario m¡nimo,9957,8681,1276,0,0,0
2018,Nuevo Le¢n,Menos de 1 s.m.,136954,127517,9437,0,0,0
2018,Nuevo Le¢n,M s de 1 hasta 2 s.m.,57243,45880,11363,0,0,0
2018,Nuevo Le¢n,M s de 10 s.m.,1339322,614297,725025,0,0,0
2018,Nuevo Le¢n,M s de 2 hasta 3 s.m.,797597,748649,48948,0,0,0
2018,Nuevo Le¢n,M s de 3 hasta 5 s.m.,2309798,1636668,673130,0,0,0
2018,Nuevo Le¢n,M s de 5 hasta 10 s.m.,346006,250765,95241,0,0,0
2018,Nuevo Le¢n,No especificado,86643,58540,28103,0,0,0
2018,Nuevo Le¢n,No recibe ingresos,603074,534706,68368,0,0,0
2018,Oaxaca,1 salario m¡nimo,18942,18127,815,0,0,0
2018,Oaxaca,Menos de 1 s.m.,2150959,1893480,257479,0,0,0
2018,Oaxaca,M s de 1 hasta 2 s.m.,13371,12048,1323,0,0,0
2018,Oaxaca,M s de 10 s.m.,902541,300931,601610,0,0,0
2018,Oaxaca,M s de 2 hasta 3 s.m.,484103,478712,5391,0,0,0
2018,Oaxaca,M s de 3 hasta 5 s.m.,913786,332727,581059,0,0,0
2018,Oaxaca,M s de 5 hasta 10 s.m.,108718,87855,20863,0,0,0
2018,Oaxaca,No especificado,13540,7629,5911,0,0,0
2018,Oaxaca,No recibe ingresos,209046,199642,9404,0,0,0
2018,Puebla,1 salario m¡nimo,5710,5217,493,0,0,0
2018,Puebla,Menos de 1 s.m.,2205150,1824508,380642,0,0,0
2018,Puebla,M s de 1 hasta 2 s.m.,24568,14693,9875,0,0,0
2018,Puebla,M s de 10 s.m.,1817867,736365,1081502,0,0,0
2018,Puebla,M s de 2 hasta 3 s.m.,1021048,996944,24104,0,0,0
2018,Puebla,M s de 3 hasta 5 s.m.,1897144,1135070,762074,0,0,0
2018,Puebla,M s de 5 hasta 10 s.m.,271593,197231,74362,0,0,0
2018,Puebla,No especificado,50995,30873,20122,0,0,0
2018,Puebla,No recibe ingresos,373900,355879,18021,0,0,0
2018,Queretaro,1 salario m¡nimo,13366,13366,0,0,0,0
2018,Queretaro,Menos de 1 s.m.,163098,153972,9126,0,0,0
2018,Queretaro,M s de 1 hasta 2 s.m.,15611,13125,2486,0,0,0
2018,Queretaro,M s de 10 s.m.,455111,205999,249112,0,0,0
2018,Queretaro,M s de 2 hasta 3 s.m.,356039,343567,12472,0,0,0
2018,Queretaro,M s de 3 hasta 5 s.m.,785022,528454,256568,0,0,0
2018,Queretaro,M s de 5 hasta 10 s.m.,108773,82162,26611,0,0,0
2018,Queretaro,No especificado,31133,22250,8883,0,0,0
2018,Queretaro,No recibe ingresos,151420,136900,14520,0,0,0
2018,Quintana Roo,1 salario m¡nimo,1701,1701,0,0,0,0
2018,Quintana Roo,Menos de 1 s.m.,169454,159149,10305,0,0,0
2018,Quintana Roo,M s de 1 hasta 2 s.m.,7946,6804,1142,0,0,0
2018,Quintana Roo,M s de 10 s.m.,462262,210982,251280,0,0,0
2018,Quintana Roo,M s de 2 hasta 3 s.m.,321643,303175,18468,0,0,0
2018,Quintana Roo,M s de 3 hasta 5 s.m.,194863,127215,67648,0,0,0
2018,Quintana Roo,M s de 5 hasta 10 s.m.,78709,55937,22772,0,0,0
2018,Quintana Roo,No especificado,26148,17537,8611,0,0,0
2018,Quintana Roo,No recibe ingresos,207384,189883,17501,0,0,0
2018,San Luis Potos¡,1 salario m¡nimo,21260,18951,2309,0,0,0
2018,San Luis Potos¡,Menos de 1 s.m.,849822,780451,69371,0,0,0
2018,San Luis Potos¡,M s de 1 hasta 2 s.m.,21566,19346,2220,0,0,0
2018,San Luis Potos¡,M s de 10 s.m.,702589,277728,424861,0,0,0
2018,San Luis Potos¡,M s de 2 hasta 3 s.m.,423191,410514,12677,0,0,0
2018,San Luis Potos¡,M s de 3 hasta 5 s.m.,952960,599622,353338,0,0,0
2018,San Luis Potos¡,M s de 5 hasta 10 s.m.,113624,89536,24088,0,0,0
2018,San Luis Potos¡,No especificado,21284,15007,6277,0,0,0
2018,San Luis Potos¡,No recibe ingresos,138176,128312,9864,0,0,0
2018,Sinaloa,1 salario m¡nimo,21810,19565,2245,0,0,0
2018,Sinaloa,Menos de 1 s.m.,866256,714151,152105,0,0,0
2018,Sinaloa,M s de 1 hasta 2 s.m.,31439,26749,4690,0,0,0
2018,Sinaloa,M s de 10 s.m.,855817,352503,503314,0,0,0
2018,Sinaloa,M s de 2 hasta 3 s.m.,491821,475194,16627,0,0,0
2018,Sinaloa,M s de 3 hasta 5 s.m.,576415,333789,242626,0,0,0
2018,Sinaloa,M s de 5 hasta 10 s.m.,218209,158580,59629,0,0,0
2018,Sinaloa,No especificado,42882,24858,18024,0,0,0
2018,Sinaloa,No recibe ingresos,161135,144324,16811,0,0,0
2018,Sonora,1 salario m¡nimo,61141,54561,6580,0,0,0
2018,Sonora,Menos de 1 s.m.,603436,498384,105052,0,0,0
2018,Sonora,M s de 1 hasta 2 s.m.,40478,34753,5725,0,0,0
2018,Sonora,M s de 10 s.m.,829935,348030,481905,0,0,0
2018,Sonora,M s de 2 hasta 3 s.m.,426909,410769,16140,0,0,0
2018,Sonora,M s de 3 hasta 5 s.m.,1010734,561547,449187,0,0,0
2018,Sonora,M s de 5 hasta 10 s.m.,221811,160492,61319,0,0,0
2018,Sonora,No especificado,49002,33901,15101,0,0,0
2018,Sonora,No recibe ingresos,155145,133330,21815,0,0,0
2018,Tabasco,1 salario m¡nimo,79355,67178,12177,0,0,0
2018,Tabasco,Menos de 1 s.m.,658451,635871,22580,0,0,0
2018,Tabasco,M s de 1 hasta 2 s.m.,12195,11221,974,0,0,0
2018,Tabasco,M s de 10 s.m.,598443,280940,317503,0,0,0
2018,Tabasco,M s de 2 hasta 3 s.m.,274217,264159,10058,0,0,0
2018,Tabasco,M s de 3 hasta 5 s.m.,293845,161477,132368,0,0,0
2018,Tabasco,M s de 5 hasta 10 s.m.,105502,78494,27008,0,0,0
2018,Tabasco,No especificado,16019,10827,5192,0,0,0
2018,Tabasco,No recibe ingresos,181712,175879,5833,0,0,0
2018,Tamaulipas,1 salario m¡nimo,39725,31453,8272,0,0,0
2018,Tamaulipas,Menos de 1 s.m.,438677,408876,29801,0,0,0
2018,Tamaulipas,M s de 1 hasta 2 s.m.,41217,39286,1931,0,0,0
2018,Tamaulipas,M s de 10 s.m.,985554,468393,517161,0,0,0
2018,Tamaulipas,M s de 2 hasta 3 s.m.,498030,474944,23086,0,0,0
2018,Tamaulipas,M s de 3 hasta 5 s.m.,1381021,853210,527811,0,0,0
2018,Tamaulipas,M s de 5 hasta 10 s.m.,181199,140712,40487,0,0,0
2018,Tamaulipas,No especificado,57674,41222,16452,0,0,0
2018,Tamaulipas,No recibe ingresos,355668,313265,42403,0,0,0
2018,Tlaxcala,1 salario m¡nimo,846,846,0,0,0,0
2018,Tlaxcala,Menos de 1 s.m.,251479,225444,26035,0,0,0
2018,Tlaxcala,M s de 1 hasta 2 s.m.,3113,3113,0,0,0,0
2018,Tlaxcala,M s de 10 s.m.,374111,156508,217603,0,0,0
2018,Tlaxcala,M s de 2 hasta 3 s.m.,227370,223900,3470,0,0,0
2018,Tlaxcala,M s de 3 hasta 5 s.m.,610453,347775,262678,0,0,0
2018,Tlaxcala,M s de 5 hasta 10 s.m.,44671,35750,8921,0,0,0
2018,Tlaxcala,No especificado,7646,4747,2899,0,0,0
2018,Tlaxcala,No recibe ingresos,59344,56950,2394,0,0,0
2018,Veracruz,1 salario m¡nimo,54009,49169,4840,0,0,0
2018,Veracruz,Menos de 1 s.m.,3160801,2980209,180592,0,0,0
2018,Veracruz,M s de 1 hasta 2 s.m.,84839,70471,14368,0,0,0
2018,Veracruz,M s de 10 s.m.,2015651,855580,1160071,0,0,0
2018,Veracruz,M s de 2 hasta 3 s.m.,1224417,1195322,29095,0,0,0
2018,Veracruz,M s de 3 hasta 5 s.m.,1046229,718039,328190,0,0,0
2018,Veracruz,M s de 5 hasta 10 s.m.,310866,216266,94600,0,0,0
2018,Veracruz,No especificado,68678,40953,27725,0,0,0
2018,Veracruz,No recibe ingresos,684743,641588,43155,0,0,0
2018,Yucat n,1 salario m¡nimo,9065,7700,1365,0,0,0
2018,Yucat n,Menos de 1 s.m.,421520,392750,28770,0,0,0
2018,Yucat n,M s de 1 hasta 2 s.m.,18337,15913,2424,0,0,0
2018,Yucat n,M s de 10 s.m.,622548,268455,354093,0,0,0
2018,Yucat n,M s de 2 hasta 3 s.m.,366700,349246,17454,0,0,0
2018,Yucat n,M s de 3 hasta 5 s.m.,730106,382879,347227,0,0,0
2018,Yucat n,M s de 5 hasta 10 s.m.,139818,103883,35935,0,0,0
2018,Yucat n,No especificado,21865,14987,6878,0,0,0
2018,Yucat n,No recibe ingresos,171571,160754,10817,0,0,0
2018,Zacatecas,1 salario m¡nimo,53403,51668,1735,0,0,0
2018,Zacatecas,Menos de 1 s.m.,567382,500847,66535,0,0,0
2018,Zacatecas,M s de 1 hasta 2 s.m.,6475,5327,1148,0,0,0
2018,Zacatecas,M s de 10 s.m.,378373,156747,221626,0,0,0
2018,Zacatecas,M s de 2 hasta 3 s.m.,243688,239972,3716,0,0,0
2018,Zacatecas,M s de 3 hasta 5 s.m.,312621,203655,108966,0,0,0
2018,Zacatecas,M s de 5 hasta 10 s.m.,71008,54484,16524,0,0,0
2018,Zacatecas,No especificado,11616,8549,3067,0,0,0
2018,Zacatecas,No recibe ingresos,43345,38394,4951,0,0,0
2019,Aguascalientes,1 salario m¡nimo,3492,3096,396,0,0,0
2019,Aguascalientes,Menos de 1 s.m.,45986,42005,3981,0,0,0
2019,Aguascalientes,M s de 1 hasta 2 s.m.,3938,2880,1058,0,0,0
2019,Aguascalientes,M s de 10 s.m.,178268,87472,90796,0,0,0
2019,Aguascalientes,M s de 2 hasta 3 s.m.,89926,85681,4245,0,0,0
2019,Aguascalientes,M s de 3 hasta 5 s.m.,288274,193405,94869,0,0,0
2019,Aguascalientes,M s de 5 hasta 10 s.m.,32347,21929,10418,0,0,0
2019,Aguascalientes,No especificado,6910,4477,2433,0,0,0
2019,Aguascalientes,No recibe ingresos,41413,38086,3327,0,0,0
2019,Baja California,1 salario m¡nimo,1987,1730,257,0,0,0
2019,Baja California,Menos de 1 s.m.,155661,111804,43857,0,0,0
2019,Baja California,M s de 1 hasta 2 s.m.,12311,9351,2960,0,0,0
2019,Baja California,M s de 10 s.m.,554042,268016,286026,0,0,0
2019,Baja California,M s de 2 hasta 3 s.m.,218894,211663,7231,0,0,0
2019,Baja California,M s de 3 hasta 5 s.m.,826659,498829,327830,0,0,0
2019,Baja California,M s de 5 hasta 10 s.m.,95913,67780,28133,0,0,0
2019,Baja California,No especificado,22890,14253,8637,0,0,0
2019,Baja California,No recibe ingresos,140804,126831,13973,0,0,0
2019,Baja California Sur,1 salario m¡nimo,5965,5782,183,0,0,0
2019,Baja California Sur,Menos de 1 s.m.,60219,49140,11079,0,0,0
2019,Baja California Sur,M s de 1 hasta 2 s.m.,5513,4729,784,0,0,0
2019,Baja California Sur,M s de 10 s.m.,125433,58539,66894,0,0,0
2019,Baja California Sur,M s de 2 hasta 3 s.m.,92112,85702,6410,0,0,0
2019,Baja California Sur,M s de 3 hasta 5 s.m.,51877,32989,18888,0,0,0
2019,Baja California Sur,M s de 5 hasta 10 s.m.,18565,11609,6956,0,0,0
2019,Baja California Sur,No especificado,7425,4491,2934,0,0,0
2019,Baja California Sur,No recibe ingresos,31378,27360,4018,0,0,0
2019,Campeche,1 salario m¡nimo,12488,9476,3012,0,0,0
2019,Campeche,Menos de 1 s.m.,173731,161371,12360,0,0,0
2019,Campeche,M s de 1 hasta 2 s.m.,2442,1975,467,0,0,0
2019,Campeche,M s de 10 s.m.,128556,53803,74753,0,0,0
2019,Campeche,M s de 2 hasta 3 s.m.,73808,68219,5589,0,0,0
2019,Campeche,M s de 3 hasta 5 s.m.,80703,39101,41602,0,0,0
2019,Campeche,M s de 5 hasta 10 s.m.,18001,14801,3200,0,0,0
2019,Campeche,No especificado,5770,3951,1819,0,0,0
2019,Campeche,No recibe ingresos,26359,24311,2048,0,0,0
2019,Chiapas,1 salario m¡nimo,3068,3068,0,0,0,0
2019,Chiapas,Menos de 1 s.m.,1428148,1364487,63661,0,0,0
2019,Chiapas,M s de 1 hasta 2 s.m.,7997,6833,1164,0,0,0
2019,Chiapas,M s de 10 s.m.,538398,192780,345618,0,0,0
2019,Chiapas,M s de 2 hasta 3 s.m.,266121,260862,5259,0,0,0
2019,Chiapas,M s de 3 hasta 5 s.m.,370969,254592,116377,0,0,0
2019,Chiapas,M s de 5 hasta 10 s.m.,76702,59174,17528,0,0,0
2019,Chiapas,No especificado,11520,5656,5864,0,0,0
2019,Chiapas,No recibe ingresos,134841,131460,3381,0,0,0
2019,Chihuahua,1 salario m¡nimo,39205,36370,2835,0,0,0
2019,Chihuahua,Menos de 1 s.m.,254112,240585,13527,0,0,0
2019,Chihuahua,M s de 1 hasta 2 s.m.,16922,14231,2691,0,0,0
2019,Chihuahua,M s de 10 s.m.,468982,235315,233667,0,0,0
2019,Chihuahua,M s de 2 hasta 3 s.m.,228648,217375,11273,0,0,0
2019,Chihuahua,M s de 3 hasta 5 s.m.,970499,594156,376343,0,0,0
2019,Chihuahua,M s de 5 hasta 10 s.m.,82932,59065,23867,0,0,0
2019,Chihuahua,No especificado,23236,13645,9591,0,0,0
2019,Chihuahua,No recibe ingresos,115853,103532,12321,0,0,0
2019,Ciudad de Mxico,1 salario m¡nimo,1990,1369,621,0,0,0
2019,Ciudad de Mxico,Menos de 1 s.m.,40564,34958,5606,0,0,0
2019,Ciudad de Mxico,M s de 1 hasta 2 s.m.,35641,21906,13735,0,0,0
2019,Ciudad de Mxico,M s de 10 s.m.,1550175,762520,787655,0,0,0
2019,Ciudad de Mxico,M s de 2 hasta 3 s.m.,501538,449477,52061,0,0,0
2019,Ciudad de Mxico,M s de 3 hasta 5 s.m.,835875,519040,316835,0,0,0
2019,Ciudad de Mxico,M s de 5 hasta 10 s.m.,247285,188675,58610,0,0,0
2019,Ciudad de Mxico,No especificado,171128,120717,50411,0,0,0
2019,Ciudad de Mxico,No recibe ingresos,563805,499687,64118,0,0,0
2019,Coahuila,1 salario m¡nimo,25990,25067,923,0,0,0
2019,Coahuila,Menos de 1 s.m.,102728,92317,10411,0,0,0
2019,Coahuila,M s de 1 hasta 2 s.m.,15127,14621,506,0,0,0
2019,Coahuila,M s de 10 s.m.,374417,161962,212455,0,0,0
2019,Coahuila,M s de 2 hasta 3 s.m.,192795,185946,6849,0,0,0
2019,Coahuila,M s de 3 hasta 5 s.m.,832661,560037,272624,0,0,0
2019,Coahuila,M s de 5 hasta 10 s.m.,78296,59044,19252,0,0,0
2019,Coahuila,No especificado,13645,9387,4258,0,0,0
2019,Coahuila,No recibe ingresos,120411,112747,7664,0,0,0
2019,Colima,1 salario m¡nimo,8581,8369,212,0,0,0
2019,Colima,Menos de 1 s.m.,99176,78629,20547,0,0,0
2019,Colima,M s de 1 hasta 2 s.m.,3231,2729,502,0,0,0
2019,Colima,M s de 10 s.m.,104206,37276,66930,0,0,0
2019,Colima,M s de 2 hasta 3 s.m.,51683,49963,1720,0,0,0
2019,Colima,M s de 3 hasta 5 s.m.,67692,38457,29235,0,0,0
2019,Colima,M s de 5 hasta 10 s.m.,24945,17823,7122,0,0,0
2019,Colima,No especificado,4675,2785,1890,0,0,0
2019,Colima,No recibe ingresos,56381,45161,11220,0,0,0
2019,Durango,1 salario m¡nimo,23802,21858,1944,0,0,0
2019,Durango,Menos de 1 s.m.,203396,191037,12359,0,0,0
2019,Durango,M s de 1 hasta 2 s.m.,6780,5239,1541,0,0,0
2019,Durango,M s de 10 s.m.,259074,97399,161675,0,0,0
2019,Durango,M s de 2 hasta 3 s.m.,134433,131525,2908,0,0,0
2019,Durango,M s de 3 hasta 5 s.m.,266099,164134,101965,0,0,0
2019,Durango,M s de 5 hasta 10 s.m.,39349,30067,9282,0,0,0
2019,Durango,No especificado,6581,4537,2044,0,0,0
2019,Durango,No recibe ingresos,58878,55517,3361,0,0,0
2019,Estado de Mxico,1 salario m¡nimo,24959,21934,3025,0,0,0
2019,Estado de Mxico,Menos de 1 s.m.,741374,664835,76539,0,0,0
2019,Estado de Mxico,M s de 1 hasta 2 s.m.,40341,39847,494,0,0,0
2019,Estado de Mxico,M s de 10 s.m.,3048860,1449097,1599763,0,0,0
2019,Estado de Mxico,M s de 2 hasta 3 s.m.,1186811,1149388,37423,0,0,0
2019,Estado de Mxico,M s de 3 hasta 5 s.m.,2642710,1832098,810612,0,0,0
2019,Estado de Mxico,M s de 5 hasta 10 s.m.,416447,289503,126944,0,0,0
2019,Estado de Mxico,No especificado,138892,107937,30955,0,0,0
2019,Estado de Mxico,No recibe ingresos,943067,859283,83784,0,0,0
2019,Guanajuato,1 salario m¡nimo,26404,24734,1670,0,0,0
2019,Guanajuato,Menos de 1 s.m.,472344,414294,58050,0,0,0
2019,Guanajuato,M s de 1 hasta 2 s.m.,16299,13111,3188,0,0,0
2019,Guanajuato,M s de 10 s.m.,703581,250753,452828,0,0,0
2019,Guanajuato,M s de 2 hasta 3 s.m.,467762,451546,16216,0,0,0
2019,Guanajuato,M s de 3 hasta 5 s.m.,1419290,894645,524645,0,0,0
2019,Guanajuato,M s de 5 hasta 10 s.m.,207347,150802,56545,0,0,0
2019,Guanajuato,No especificado,16988,12883,4105,0,0,0
2019,Guanajuato,No recibe ingresos,140572,129673,10899,0,0,0
2019,Guerrero,1 salario m¡nimo,13234,12387,847,0,0,0
2019,Guerrero,Menos de 1 s.m.,772245,670315,101930,0,0,0
2019,Guerrero,M s de 1 hasta 2 s.m.,8750,6898,1852,0,0,0
2019,Guerrero,M s de 10 s.m.,469144,174105,295039,0,0,0
2019,Guerrero,M s de 2 hasta 3 s.m.,210324,207576,2748,0,0,0
2019,Guerrero,M s de 3 hasta 5 s.m.,287421,108349,179072,0,0,0
2019,Guerrero,M s de 5 hasta 10 s.m.,58410,52390,6020,0,0,0
2019,Guerrero,No especificado,11083,7228,3855,0,0,0
2019,Guerrero,No recibe ingresos,106077,102705,3372,0,0,0
2019,Hidalgo,1 salario m¡nimo,3797,3797,0,0,0,0
2019,Hidalgo,Menos de 1 s.m.,506343,418203,88140,0,0,0
2019,Hidalgo,M s de 1 hasta 2 s.m.,6298,4634,1664,0,0,0
2019,Hidalgo,M s de 10 s.m.,398617,168190,230427,0,0,0
2019,Hidalgo,M s de 2 hasta 3 s.m.,232061,223602,8459,0,0,0
2019,Hidalgo,M s de 3 hasta 5 s.m.,429867,241129,188738,0,0,0
2019,Hidalgo,M s de 5 hasta 10 s.m.,58452,44944,13508,0,0,0
2019,Hidalgo,No especificado,7443,4996,2447,0,0,0
2019,Hidalgo,No recibe ingresos,82129,79655,2474,0,0,0
2019,Jalisco,1 salario m¡nimo,6960,6960,0,0,0,0
2019,Jalisco,Menos de 1 s.m.,612170,538764,73406,0,0,0
2019,Jalisco,M s de 1 hasta 2 s.m.,16445,11169,5276,0,0,0
2019,Jalisco,M s de 10 s.m.,1271058,603513,667545,0,0,0
2019,Jalisco,M s de 2 hasta 3 s.m.,631849,613710,18139,0,0,0
2019,Jalisco,M s de 3 hasta 5 s.m.,1382172,923016,459156,0,0,0
2019,Jalisco,M s de 5 hasta 10 s.m.,299660,232754,66906,0,0,0
2019,Jalisco,No especificado,52197,31815,20382,0,0,0
2019,Jalisco,No recibe ingresos,267121,235957,31164,0,0,0
2019,Michoac n,1 salario m¡nimo,167,69,98,0,0,0
2019,Michoac n,Menos de 1 s.m.,992977,879653,113324,0,0,0
2019,Michoac n,M s de 1 hasta 2 s.m.,10970,9121,1849,0,0,0
2019,Michoac n,M s de 10 s.m.,735905,291172,444733,0,0,0
2019,Michoac n,M s de 2 hasta 3 s.m.,329627,322314,7313,0,0,0
2019,Michoac n,M s de 3 hasta 5 s.m.,469731,312152,157579,0,0,0
2019,Michoac n,M s de 5 hasta 10 s.m.,146226,108491,37735,0,0,0
2019,Michoac n,No especificado,15593,9618,5975,0,0,0
2019,Michoac n,No recibe ingresos,107358,98529,8829,0,0,0
2019,Morelos,1 salario m¡nimo,887,887,0,0,0,0
2019,Morelos,Menos de 1 s.m.,204727,189438,15289,0,0,0
2019,Morelos,M s de 1 hasta 2 s.m.,4104,3724,380,0,0,0
2019,Morelos,M s de 10 s.m.,303849,129913,173936,0,0,0
2019,Morelos,M s de 2 hasta 3 s.m.,151190,148946,2244,0,0,0
2019,Morelos,M s de 3 hasta 5 s.m.,191355,127682,63673,0,0,0
2019,Morelos,M s de 5 hasta 10 s.m.,42052,33464,8588,0,0,0
2019,Morelos,No especificado,11380,7226,4154,0,0,0
2019,Morelos,No recibe ingresos,75855,72339,3516,0,0,0
2019,Nacional,1 salario m¡nimo,426413,374886,51527,0,0,0
2019,Nacional,Menos de 1 s.m.,13322509,11889543,1432966,0,0,0
2019,Nacional,M s de 1 hasta 2 s.m.,387684,309929,77755,0,0,0
2019,Nacional,M s de 10 s.m.,17967872,7843606,10124266,0,0,0
2019,Nacional,M s de 2 hasta 3 s.m.,8607424,8287984,319440,0,0,0
2019,Nacional,M s de 3 hasta 5 s.m.,18130952,11384329,6746623,0,0,0
2019,Nacional,M s de 5 hasta 10 s.m.,3156057,2354838,801219,0,0,0
2019,Nacional,No especificado,795748,548739,247009,0,0,0
2019,Nacional,No recibe ingresos,4826009,4387404,438605,0,0,0
2019,Nayarit,1 salario m¡nimo,703,703,0,0,0,0
2019,Nayarit,Menos de 1 s.m.,229409,212824,16585,0,0,0
2019,Nayarit,M s de 1 hasta 2 s.m.,3706,3019,687,0,0,0
2019,Nayarit,M s de 10 s.m.,192853,64953,127900,0,0,0
2019,Nayarit,M s de 2 hasta 3 s.m.,101963,98639,3324,0,0,0
2019,Nayarit,M s de 3 hasta 5 s.m.,108312,52671,55641,0,0,0
2019,Nayarit,M s de 5 hasta 10 s.m.,25897,20547,5350,0,0,0
2019,Nayarit,No especificado,5695,3799,1896,0,0,0
2019,Nayarit,No recibe ingresos,40196,36312,3884,0,0,0
2019,Nuevo Le¢n,1 salario m¡nimo,7721,7237,484,0,0,0
2019,Nuevo Le¢n,Menos de 1 s.m.,75726,69240,6486,0,0,0
2019,Nuevo Le¢n,M s de 1 hasta 2 s.m.,21318,16341,4977,0,0,0
2019,Nuevo Le¢n,M s de 10 s.m.,694168,319190,374978,0,0,0
2019,Nuevo Le¢n,M s de 2 hasta 3 s.m.,376957,356630,20327,0,0,0
2019,Nuevo Le¢n,M s de 3 hasta 5 s.m.,1147044,815221,331823,0,0,0
2019,Nuevo Le¢n,M s de 5 hasta 10 s.m.,167834,126354,41480,0,0,0
2019,Nuevo Le¢n,No especificado,43407,33531,9876,0,0,0
2019,Nuevo Le¢n,No recibe ingresos,317238,280465,36773,0,0,0
2019,Oaxaca,1 salario m¡nimo,21778,15522,6256,0,0,0
2019,Oaxaca,Menos de 1 s.m.,1026306,859029,167277,0,0,0
2019,Oaxaca,M s de 1 hasta 2 s.m.,4474,3786,688,0,0,0
2019,Oaxaca,M s de 10 s.m.,500647,166756,333891,0,0,0
2019,Oaxaca,M s de 2 hasta 3 s.m.,230354,228565,1789,0,0,0
2019,Oaxaca,M s de 3 hasta 5 s.m.,504448,178265,326183,0,0,0
2019,Oaxaca,M s de 5 hasta 10 s.m.,63589,53789,9800,0,0,0
2019,Oaxaca,No especificado,3838,1990,1848,0,0,0
2019,Oaxaca,No recibe ingresos,112311,106968,5343,0,0,0
2019,Puebla,1 salario m¡nimo,3870,3148,722,0,0,0
2019,Puebla,Menos de 1 s.m.,1142727,940553,202174,0,0,0
2019,Puebla,M s de 1 hasta 2 s.m.,16186,10909,5277,0,0,0
2019,Puebla,M s de 10 s.m.,930756,367470,563286,0,0,0
2019,Puebla,M s de 2 hasta 3 s.m.,521370,507592,13778,0,0,0
2019,Puebla,M s de 3 hasta 5 s.m.,926381,558453,367928,0,0,0
2019,Puebla,M s de 5 hasta 10 s.m.,127347,96937,30410,0,0,0
2019,Puebla,No especificado,29226,19215,10011,0,0,0
2019,Puebla,No recibe ingresos,180131,167866,12265,0,0,0
2019,Queretaro,1 salario m¡nimo,6505,5805,700,0,0,0
2019,Queretaro,Menos de 1 s.m.,77649,71343,6306,0,0,0
2019,Queretaro,M s de 1 hasta 2 s.m.,8878,7386,1492,0,0,0
2019,Queretaro,M s de 10 s.m.,216057,92950,123107,0,0,0
2019,Queretaro,M s de 2 hasta 3 s.m.,163418,158069,5349,0,0,0
2019,Queretaro,M s de 3 hasta 5 s.m.,387077,259691,127386,0,0,0
2019,Queretaro,M s de 5 hasta 10 s.m.,61615,44489,17126,0,0,0
2019,Queretaro,No especificado,15208,10455,4753,0,0,0
2019,Queretaro,No recibe ingresos,82450,74568,7882,0,0,0
2019,Quintana Roo,1 salario m¡nimo,1222,1021,201,0,0,0
2019,Quintana Roo,Menos de 1 s.m.,85767,77121,8646,0,0,0
2019,Quintana Roo,M s de 1 hasta 2 s.m.,4852,3748,1104,0,0,0
2019,Quintana Roo,M s de 10 s.m.,249833,117592,132241,0,0,0
2019,Quintana Roo,M s de 2 hasta 3 s.m.,158051,147711,10340,0,0,0
2019,Quintana Roo,M s de 3 hasta 5 s.m.,105350,67444,37906,0,0,0
2019,Quintana Roo,M s de 5 hasta 10 s.m.,39481,28618,10863,0,0,0
2019,Quintana Roo,No especificado,10430,7329,3101,0,0,0
2019,Quintana Roo,No recibe ingresos,103307,92785,10522,0,0,0
2019,San Luis Potos¡,1 salario m¡nimo,8217,6930,1287,0,0,0
2019,San Luis Potos¡,Menos de 1 s.m.,389950,361829,28121,0,0,0
2019,San Luis Potos¡,M s de 1 hasta 2 s.m.,8331,6922,1409,0,0,0
2019,San Luis Potos¡,M s de 10 s.m.,370859,149825,221034,0,0,0
2019,San Luis Potos¡,M s de 2 hasta 3 s.m.,186000,178786,7214,0,0,0
2019,San Luis Potos¡,M s de 3 hasta 5 s.m.,488360,314016,174344,0,0,0
2019,San Luis Potos¡,M s de 5 hasta 10 s.m.,65004,50857,14147,0,0,0
2019,San Luis Potos¡,No especificado,13276,9755,3521,0,0,0
2019,San Luis Potos¡,No recibe ingresos,90329,81577,8752,0,0,0
2019,Sinaloa,1 salario m¡nimo,6799,6235,564,0,0,0
2019,Sinaloa,Menos de 1 s.m.,417554,363513,54041,0,0,0
2019,Sinaloa,M s de 1 hasta 2 s.m.,14000,13409,591,0,0,0
2019,Sinaloa,M s de 10 s.m.,450470,200348,250122,0,0,0
2019,Sinaloa,M s de 2 hasta 3 s.m.,234150,223631,10519,0,0,0
2019,Sinaloa,M s de 3 hasta 5 s.m.,270106,156974,113132,0,0,0
2019,Sinaloa,M s de 5 hasta 10 s.m.,105460,74838,30622,0,0,0
2019,Sinaloa,No especificado,16215,9208,7007,0,0,0
2019,Sinaloa,No recibe ingresos,85607,77333,8274,0,0,0
2019,Sonora,1 salario m¡nimo,31384,28108,3276,0,0,0
2019,Sonora,Menos de 1 s.m.,375116,307945,67171,0,0,0
2019,Sonora,M s de 1 hasta 2 s.m.,16401,11597,4804,0,0,0
2019,Sonora,M s de 10 s.m.,425592,191186,234406,0,0,0
2019,Sonora,M s de 2 hasta 3 s.m.,198085,183312,14773,0,0,0
2019,Sonora,M s de 3 hasta 5 s.m.,501927,287748,214179,0,0,0
2019,Sonora,M s de 5 hasta 10 s.m.,107822,68941,38881,0,0,0
2019,Sonora,No especificado,26973,19343,7630,0,0,0
2019,Sonora,No recibe ingresos,64126,56983,7143,0,0,0
2019,Tabasco,1 salario m¡nimo,53775,44906,8869,0,0,0
2019,Tabasco,Menos de 1 s.m.,337341,321224,16117,0,0,0
2019,Tabasco,M s de 1 hasta 2 s.m.,5698,4661,1037,0,0,0
2019,Tabasco,M s de 10 s.m.,330954,145171,185783,0,0,0
2019,Tabasco,M s de 2 hasta 3 s.m.,133494,127888,5606,0,0,0
2019,Tabasco,M s de 3 hasta 5 s.m.,153000,90642,62358,0,0,0
2019,Tabasco,M s de 5 hasta 10 s.m.,58642,42100,16542,0,0,0
2019,Tabasco,No especificado,11000,7283,3717,0,0,0
2019,Tabasco,No recibe ingresos,89976,84560,5416,0,0,0
2019,Tamaulipas,1 salario m¡nimo,11133,9750,1383,0,0,0
2019,Tamaulipas,Menos de 1 s.m.,253315,238826,14489,0,0,0
2019,Tamaulipas,M s de 1 hasta 2 s.m.,23904,21367,2537,0,0,0
2019,Tamaulipas,M s de 10 s.m.,500049,221959,278090,0,0,0
2019,Tamaulipas,M s de 2 hasta 3 s.m.,238861,230977,7884,0,0,0
2019,Tamaulipas,M s de 3 hasta 5 s.m.,716320,433961,282359,0,0,0
2019,Tamaulipas,M s de 5 hasta 10 s.m.,78461,63412,15049,0,0,0
2019,Tamaulipas,No especificado,22950,14206,8744,0,0,0
2019,Tamaulipas,No recibe ingresos,196279,169641,26638,0,0,0
2019,Tlaxcala,1 salario m¡nimo,599,599,0,0,0,0
2019,Tlaxcala,Menos de 1 s.m.,133838,116601,17237,0,0,0
2019,Tlaxcala,M s de 1 hasta 2 s.m.,2519,2232,287,0,0,0
2019,Tlaxcala,M s de 10 s.m.,200032,84287,115745,0,0,0
2019,Tlaxcala,M s de 2 hasta 3 s.m.,114306,112244,2062,0,0,0
2019,Tlaxcala,M s de 3 hasta 5 s.m.,305675,173576,132099,0,0,0
2019,Tlaxcala,M s de 5 hasta 10 s.m.,21899,17598,4301,0,0,0
2019,Tlaxcala,No especificado,3828,2647,1181,0,0,0
2019,Tlaxcala,No recibe ingresos,27765,26366,1399,0,0,0
2019,Veracruz,1 salario m¡nimo,39827,29780,10047,0,0,0
2019,Veracruz,Menos de 1 s.m.,1421826,1356998,64828,0,0,0
2019,Veracruz,M s de 1 hasta 2 s.m.,31477,20748,10729,0,0,0
2019,Veracruz,M s de 10 s.m.,1162347,488199,674148,0,0,0
2019,Veracruz,M s de 2 hasta 3 s.m.,570744,559704,11040,0,0,0
2019,Veracruz,M s de 3 hasta 5 s.m.,585178,380593,204585,0,0,0
2019,Veracruz,M s de 5 hasta 10 s.m.,190827,147807,43020,0,0,0
2019,Veracruz,No especificado,47150,29813,17337,0,0,0
2019,Veracruz,No recibe ingresos,326258,298428,27830,0,0,0
2019,Yucat n,1 salario m¡nimo,3294,3130,164,0,0,0
2019,Yucat n,Menos de 1 s.m.,223122,207833,15289,0,0,0
2019,Yucat n,M s de 1 hasta 2 s.m.,8264,6994,1270,0,0,0
2019,Yucat n,M s de 10 s.m.,313768,131433,182335,0,0,0
2019,Yucat n,M s de 2 hasta 3 s.m.,195024,187119,7905,0,0,0
2019,Yucat n,M s de 3 hasta 5 s.m.,357732,188138,169594,0,0,0
2019,Yucat n,M s de 5 hasta 10 s.m.,67978,49975,18003,0,0,0
2019,Yucat n,No especificado,13703,10649,3054,0,0,0
2019,Yucat n,No recibe ingresos,80251,73799,6452,0,0,0
2019,Zacatecas,1 salario m¡nimo,26610,25059,1551,0,0,0
2019,Zacatecas,Menos de 1 s.m.,266962,242829,24133,0,0,0
2019,Zacatecas,M s de 1 hasta 2 s.m.,4567,3812,755,0,0,0
2019,Zacatecas,M s de 10 s.m.,216922,80462,136460,0,0,0
2019,Zacatecas,M s de 2 hasta 3 s.m.,125065,123622,1443,0,0,0
2019,Zacatecas,M s de 3 hasta 5 s.m.,160188,93125,67063,0,0,0
2019,Zacatecas,M s de 5 hasta 10 s.m.,31272,26261,5011,0,0,0
2019,Zacatecas,No especificado,5493,3914,1579,0,0,0
2019,Zacatecas,No recibe ingresos,17483,16920,563,0,0,0
